,Molecular weight,Average Residue Weight,Isoelectric Point,A280 Molar Extinction Coefficients,Improbability of expression in inclusion bodies,Tiny,Small,Aliphatic,Aromatic,Non-polar,Polar,Charged,Basic,Acidic,Total Residues
P48813,73598.01,111.008,7.7144,110240,0.775,202,331,211,87,397,266,134,73,61,663
P53241,69082.80,116.497,9.0584,183120,0.804,161,274,171,113,348,245,127,76,51,593
P33550,50651.34,119.180,5.5352,93740,0.534,95,179,94,79,220,205,115,57,58,425
Q02207,98703.18,109.670,9.4507,98210,0.840,271,469,283,102,496,404,213,123,90,900
P21375,55065.14,109.910,9.4952,28880,0.874,145,261,149,42,250,251,124,72,52,501
P04046,56719.37,111.214,6.1969,37250,0.658,145,267,148,55,279,231,137,70,67,510
P10659,41818.34,109.472,4.8347,42860,,120,201,118,38,208,174,107,50,57,382
P22438,66734.42,116.060,9.0431,97750,0.838,126,251,149,80,287,288,157,91,66,575
Q01574,79140.82,110.997,6.5885,112190,0.640,211,377,213,89,387,326,183,97,86,713
P36024,62478.15,111.171,4.3279,47440,,148,315,131,29,231,331,174,71,103,562
P13711,84042.18,112.356,8.6535,95690,0.742,208,370,220,89,393,355,190,106,84,748
P22203,26471.38,113.611,5.0145,7450,,50,96,76,10,105,128,78,37,41,233
P00890,53360.08,111.399,8.5132,62800,0.725,139,221,150,57,258,221,131,73,58,479
P38113,37648.11,107.260,6.3330,45380,0.691,115,196,114,40,215,136,78,41,37,351
Q06236,18631.78,110.903,9.7812,21430,0.898,53,80,52,24,99,69,33,23,10,168
Q12429,77940.66,113.782,5.7064,65780,0.555,161,319,189,78,340,345,181,91,90,685
P06174,30911.59,112.406,8.2493,17420,0.738,68,136,85,25,137,138,80,44,36,275
Q12116,52230.16,110.423,5.1453,104280,0.650,166,257,156,66,286,187,64,31,33,473
P32610,29194.01,114.039,5.6022,11920,,65,113,76,18,116,140,83,41,42,256
P23641,32812.09,105.505,9.7078,19370,0.951,120,165,100,37,199,112,45,28,17,311
P08678,227833.86,112.455,7.2970,147950,0.837,570,1038,518,196,899,1127,535,292,243,2026
P40527,130217.99,113.135,6.4260,131560,0.577,312,563,354,137,588,563,279,146,133,1151
P19414,85368.24,109.728,8.1500,89270,0.787,228,415,226,78,422,356,208,114,94,778
P40445,61898.08,114.203,9.2277,99240,0.802,142,239,172,75,312,230,114,65,49,542
P32191,72388.93,111.539,7.8975,83770,0.723,188,338,194,74,353,296,155,85,70,649
Q12494,119550.05,113.857,6.7732,88700,0.773,276,524,228,113,428,622,327,176,151,1050
Q12074,33324.06,113.734,5.2388,45380,,74,137,85,39,153,140,84,41,43,293
P32476,55125.88,111.141,6.4338,33350,0.643,119,250,160,54,293,203,127,66,61,496
P54783,59493.68,113.106,6.7578,112300,0.767,147,271,138,72,281,245,122,64,58,526
P53224,25244.75,113.715,6.6059,46410,0.649,66,111,62,34,118,104,46,25,21,222
Q05919,50859.87,115.854,9.3509,43780,0.800,97,173,131,54,216,223,117,69,48,439
P38071,42066.81,110.702,9.4789,52370,0.903,114,202,105,35,181,199,92,52,40,380
P03965,123915.33,110.837,4.9520,109560,0.514,313,569,364,113,604,514,279,132,147,1118
P07251,58608.00,107.538,9.4854,31860,0.800,179,283,200,37,303,242,128,70,58,545
P33330,43415.57,109.913,6.5050,35870,0.642,108,198,128,45,216,179,104,55,49,395
P49435,20586.86,110.090,4.7506,8940,,48,83,68,23,117,70,44,20,24,187
P38795,80685.69,113.005,6.4995,92250,0.639,192,343,206,81,392,322,182,95,87,714
Q04162,61508.94,110.827,8.1366,67270,0.788,180,277,196,69,340,215,85,47,38,555
P38773,27165.05,110.427,5.3949,25440,0.575,67,134,74,23,130,116,65,32,33,246
P36060,34137.91,113.039,9.0484,29910,0.839,73,146,74,45,154,148,83,48,35,302
P33413,80616.89,109.683,5.3597,122620,0.567,240,377,264,98,472,263,118,58,60,735
P47125,50775.33,112.087,8.0181,49850,0.782,129,219,132,47,238,215,119,68,51,453
P40885,62857.75,110.860,8.2283,108750,0.815,189,295,172,84,349,218,89,49,40,567
P13188,93132.83,115.121,8.6206,107150,0.773,188,383,193,97,383,426,255,139,116,809
P53101,51828.46,111.459,8.0111,34380,0.826,123,248,137,45,237,228,113,64,49,465
P38169,52429.50,113.977,8.5199,41830,0.712,121,201,129,57,239,221,134,76,58,460
P29703,37507.74,118.695,4.7475,88810,,61,133,93,52,168,148,87,40,47,316
P38088,78184.27,113.311,6.4663,66810,0.544,169,325,198,75,350,340,226,116,110,690
P32469,33847.39,112.825,4.5552,42860,,81,139,92,33,159,141,85,37,48,300
P53839,38831.41,110.947,6.2889,23950,0.604,89,173,108,32,185,165,100,52,48,350
P04803,43015.44,113.497,9.6181,39880,0.817,92,178,110,44,188,191,108,64,44,379
P40464,34409.21,110.641,10.4164,41370,0.775,94,148,105,35,179,132,58,41,17,311
P43616,52871.38,109.920,5.3568,49850,0.654,141,249,136,52,260,221,122,60,62,481
P42951,70216.93,115.679,6.6675,119750,0.746,148,286,136,91,293,314,162,87,75,607
P23501,46488.15,115.070,7.6327,95800,0.638,109,190,125,73,246,158,85,50,35,404
Q12055,22723.14,115.346,4.2737,29910,,40,98,48,22,91,106,71,28,43,197
Q12256,73222.87,111.112,8.2768,104280,0.803,201,339,199,83,391,268,132,72,60,659
P0CX10,47327.58,108.301,4.9388,48360,0.520,142,233,144,41,244,193,110,52,58,437
Q12109,49350.33,114.237,6.7656,34380,0.518,104,203,106,59,216,216,132,69,63,432
P42833,60978.63,112.923,7.5413,96260,0.736,148,243,176,79,336,204,88,48,40,540
P43577,18134.90,114.056,4.8703,21430,,38,70,45,16,84,75,45,21,24,159
P43549,70507.33,109.144,8.6197,101300,0.931,222,357,163,70,341,305,145,80,65,646
Q08227,43799.01,114.060,7.5917,69330,0.778,101,187,105,51,201,183,89,49,40,384
P25087,43430.83,113.396,5.5173,61770,,109,186,99,55,201,182,111,55,56,383
P40506,41866.95,114.704,8.3836,42860,0.711,87,166,104,46,180,185,100,56,44,365
P12695,51818.09,107.506,7.7512,24410,0.787,165,266,155,27,246,236,116,60,56,482
P40039,58050.16,109.943,5.2186,118720,0.620,176,277,189,86,355,173,76,37,39,528
Q03262,71069.05,114.259,6.2093,96720,0.549,145,295,168,92,335,287,168,87,81,622
Q12436,46362.99,109.865,4.8280,53860,,133,214,138,63,254,168,86,40,46,422
P05626,26925.08,110.349,9.6667,14440,0.785,71,119,86,16,123,121,61,34,27,244
Q12233,12921.13,112.358,10.2766,14900,0.591,31,47,37,15,65,50,23,18,5,115
P39692,114828.62,110.946,4.9148,106120,0.570,281,523,338,121,556,479,255,120,135,1035
P16140,57749.25,111.701,4.6895,33810,,138,255,151,47,268,249,146,66,80,517
P38709,56000.31,113.591,4.9825,44350,0.538,112,232,151,54,253,240,122,58,64,493
P38331,27576.59,115.868,6.8453,39880,,57,106,67,26,115,123,75,39,36,238
P53164,43516.48,113.324,6.2412,51340,0.744,110,196,100,50,198,186,88,45,43,384
P04385,57944.32,109.743,6.7018,46300,0.737,162,286,164,60,295,233,123,65,58,528
P00950,27608.56,111.776,9.3113,40910,0.790,62,121,79,24,132,115,73,40,33,247
P49775,23541.73,114.280,7.5129,35410,0.699,47,98,57,25,103,103,56,31,25,206
P17649,52946.24,112.412,6.7675,65780,0.658,126,224,134,63,257,214,130,69,61,471
Q12447,21947.42,114.908,5.6395,14440,,38,70,59,19,97,94,56,28,28,191
P19145,65655.54,109.062,8.6003,110810,0.826,195,309,208,83,390,212,107,60,47,602
P20485,66316.64,113.946,5.3395,101760,0.688,149,280,158,62,279,303,153,75,78,582
Q08650,47711.35,114.142,9.9941,64290,0.824,111,196,120,62,236,182,92,60,32,418
P04817,65785.47,111.501,8.5021,119290,0.756,183,288,194,95,373,217,106,59,47,590
P18900,52559.53,111.120,9.2254,22920,0.833,129,229,151,42,242,231,132,77,55,473
Q12178,17506.98,110.804,5.7238,19940,0.611,48,79,36,15,86,72,46,23,23,158
P07264,85794.46,110.134,5.6849,69330,0.574,230,402,222,75,409,370,220,110,110,779
P40970,63110.82,112.497,8.1224,60740,0.776,155,271,162,66,315,246,141,79,62,561
P53629,74022.90,115.300,7.6984,129720,0.622,172,288,188,108,363,279,139,77,62,642
P38279,33496.60,113.164,5.1075,45380,0.667,68,126,109,37,189,107,50,24,26,296
P13298,24664.50,109.135,5.8450,13410,0.619,69,104,82,22,131,95,50,25,25,226
P38143,18406.12,113.618,8.7498,15930,0.882,40,73,36,21,81,81,42,23,19,162
P35206,45442.11,110.834,7.1988,61880,0.808,122,208,139,47,245,165,62,33,29,410
P49367,75150.73,108.443,7.3428,85830,0.801,216,374,220,63,377,316,163,89,74,693
Q99312,51329.96,114.067,5.0740,55350,,110,208,130,52,227,223,129,62,67,450
P18562,24594.47,113.863,5.4330,14900,0.567,50,95,65,22,122,94,59,29,30,216
P38427,123017.86,112.038,6.6030,117690,0.768,299,563,310,114,527,571,261,138,123,1098
Q08908,80292.37,115.695,8.8062,166160,0.661,179,294,217,123,405,289,177,106,71,694
P24031,52776.59,113.012,4.2072,83200,,140,251,118,71,246,221,109,42,67,467
P25371,117231.43,111.755,4.7793,85610,0.617,294,522,308,117,576,473,234,108,126,1049
P20107,48344.87,109.378,6.3317,40910,0.618,136,229,154,55,239,203,100,55,45,442
P48526,115793.60,115.562,8.2411,161580,0.718,234,423,278,132,493,509,278,159,119,1002
P81449,10875.51,113.287,5.8871,4470,0.534,21,44,31,9,49,47,30,15,15,96
Q12525,36714.83,113.317,5.2553,50880,0.620,81,151,89,41,173,151,84,41,43,324
P0CH63,25152.48,111.789,5.9257,29910,0.504,66,123,71,27,121,104,51,26,25,225
P34227,29495.86,113.011,9.2932,29450,0.772,66,134,75,30,133,128,70,39,31,261
Q06702,34642.37,115.091,4.4813,60390,,75,142,82,42,163,138,77,33,44,301
P53848,93119.94,113.010,6.3976,68300,0.616,197,393,248,84,418,406,223,116,107,824
Q12320,32338.83,113.470,7.4160,35870,0.726,79,136,71,35,146,139,78,44,34,285
P37291,52218.46,111.340,7.3890,50770,0.709,134,235,138,57,254,215,125,70,55,469
P40308,73612.57,114.661,8.5353,78730,0.778,147,285,199,73,345,297,150,85,65,642
P00359,35746.67,107.671,6.9152,32890,0.690,110,196,109,32,180,152,84,45,39,332
P32604,52594.92,116.360,6.7585,72770,0.633,98,198,120,54,220,232,136,70,66,452
P53950,128140.50,109.992,5.8447,49740,0.906,342,706,257,96,447,718,283,144,139,1165
P38139,43286.80,115.431,6.4964,58900,0.508,78,168,110,51,199,176,103,54,49,375
P23968,22595.74,106.083,8.2296,29910,0.822,79,111,88,27,148,65,26,15,11,213
P38702,40825.27,114.356,9.9981,59820,0.765,99,162,105,58,202,155,88,58,30,357
P22217,11234.98,109.077,4.5408,9970,,30,56,37,10,62,41,23,10,13,103
Q08929,71288.67,117.059,9.9478,139230,0.787,141,253,192,112,366,243,119,78,41,609
Q04728,47848.77,108.501,7.0327,28420,0.752,145,245,137,31,227,214,98,50,48,441
P19807,62056.03,110.224,6.8300,110810,0.762,190,290,183,91,356,207,90,50,40,563
P12945,98905.22,115.814,9.1298,114030,0.715,190,358,237,108,420,434,264,145,119,854
P38361,62653.51,109.152,6.3914,127310,0.711,192,307,208,71,356,218,91,47,44,574
P07342,74936.76,109.078,8.8024,59360,0.802,207,367,208,64,378,309,162,91,71,687
P04037,17142.57,110.597,6.8454,18450,0.749,46,83,41,14,82,73,41,22,19,155
P07245,102205.13,108.039,6.8163,42290,0.687,286,511,316,77,530,416,229,122,107,946
P40989,216989.81,114.506,7.0099,355480,0.656,505,878,535,298,1089,806,420,227,193,1895
P53230,44199.64,114.804,10.0931,49280,0.824,97,171,96,57,193,192,97,63,34,385
Q12382,32840.15,113.242,9.0999,61880,0.799,82,137,95,48,170,120,58,35,23,290
P40556,41954.44,112.478,8.7670,40340,0.803,111,176,111,53,211,162,73,44,29,373
P40353,61036.00,116.259,6.9393,83770,0.662,115,229,133,79,275,250,141,77,64,525
P06700,63261.90,112.566,8.6105,49280,0.841,139,280,160,64,293,269,145,85,60,562
Q06143,32991.54,110.710,10.1016,41370,0.778,92,152,94,35,180,118,62,40,22,298
P11353,37711.56,114.974,6.7771,64860,0.582,84,155,74,49,170,158,96,52,44,328
P32462,50615.46,115.560,9.0624,108750,0.796,102,176,141,75,276,162,86,52,34,438
P25335,38713.77,112.868,6.3198,62910,0.576,93,165,92,49,182,161,105,55,50,343
Q12458,34755.02,111.394,7.0543,48930,0.724,81,157,100,31,169,143,79,42,37,312
P50944,80025.86,112.238,9.7215,65780,0.911,191,348,222,97,405,308,139,84,55,713
P32386,189162.39,113.885,8.1737,242370,0.710,421,749,547,217,906,755,377,206,171,1661
P43623,36971.43,108.739,6.0432,46410,0.636,111,174,106,35,195,145,84,43,41,340
P21801,30231.21,113.651,8.9448,38390,0.703,80,129,71,26,142,124,63,40,23,266
Q07938,37856.55,112.334,7.7445,32890,0.822,93,166,88,42,183,154,80,46,34,337
P28273,140427.70,109.197,6.7460,96150,0.780,402,668,375,129,686,600,322,170,152,1286
P52910,75491.63,110.529,6.6562,117690,0.662,203,366,207,86,382,301,173,93,80,683
P0CD99,68189.25,111.969,8.6073,123760,0.816,199,297,185,83,359,250,121,69,52,609
P32804,41581.68,110.590,5.5964,84340,0.632,125,203,120,59,231,145,64,32,32,376
P32903,4500.57,112.514,12.0588,6990,,11,15,19,4,30,10,5,5,0,40
Q07560,32019.67,113.144,10.1349,38850,0.739,79,130,94,35,167,116,55,36,19,283
Q12001,62783.01,115.410,9.3517,140150,0.862,138,233,179,112,363,181,79,53,26,544
P53954,63143.24,115.225,9.3834,118260,0.851,124,247,155,82,303,245,134,78,56,548
P54115,54414.16,108.828,5.0768,45840,0.617,157,270,155,45,280,220,121,58,63,500
P06182,30080.84,111.825,5.1771,44460,0.754,73,144,54,30,139,130,72,35,37,269
Q06321,136054.37,113.568,7.5316,151610,0.755,313,574,318,146,581,617,335,180,155,1198
P05316,71735.89,113.327,7.9319,170170,0.802,193,314,195,115,393,240,107,61,46,633
Q12305,15413.27,110.887,6.3280,25440,0.842,39,76,35,18,72,67,36,19,17,139
P41911,49421.68,112.322,7.0658,46870,0.552,116,207,141,55,236,204,119,68,51,440
P38967,65404.43,110.480,8.3638,117340,0.836,184,290,204,88,375,217,105,63,42,592
P31116,38502.12,107.248,7.3121,25900,0.758,117,204,127,31,196,163,83,43,40,359
P34163,62979.11,114.925,6.8140,71850,0.651,127,258,163,77,278,270,139,76,63,548
P43619,32364.96,109.712,5.6367,39420,0.601,94,154,89,30,161,134,74,37,37,295
P32784,85694.31,112.904,7.2553,57760,0.694,198,354,220,85,389,370,215,116,99,759
P05694,85859.95,111.943,6.4000,86750,0.596,201,382,241,84,405,362,207,106,101,767
P39524,153764.75,113.480,5.1383,176480,,357,644,397,176,708,647,337,163,174,1355
Q08295,68624.53,116.510,5.2023,150230,0.592,146,276,122,97,284,305,179,87,92,589
Q06147,77565.55,112.905,6.8394,59710,0.782,195,344,168,70,316,371,204,108,96,687
P32263,30131.80,105.356,5.1700,18910,0.636,102,160,99,18,167,119,58,28,30,286
P05373,37740.22,110.352,6.0416,31860,0.577,101,176,112,39,203,139,88,45,43,342
P11154,130099.48,110.441,6.1523,90190,0.538,327,605,378,115,647,531,312,160,152,1178
P32466,62557.59,110.331,7.0131,102220,0.785,186,299,168,85,368,199,85,44,41,567
Q02896,37230.85,117.447,7.0898,113790,0.580,73,127,104,62,206,111,52,29,23,317
P36156,43273.71,116.956,6.8677,84800,0.528,89,170,92,64,179,191,114,62,52,370
P13663,39543.69,108.339,6.6820,21430,0.670,108,191,126,28,209,156,95,50,45,365
P47013,47371.75,115.823,9.1074,90760,0.834,101,186,120,73,258,151,82,53,29,409
P32861,55987.95,112.200,7.4083,32890,0.758,125,246,150,51,247,252,139,77,62,499
P53037,130064.98,114.293,7.9030,125140,0.814,301,553,277,137,519,619,325,178,147,1138
P38158,68142.30,116.682,5.4421,148740,0.557,144,269,121,102,287,297,174,86,88,584
P15380,68787.52,109.709,7.5137,131780,0.797,210,335,207,88,393,234,109,61,48,627
P36051,105693.42,115.009,6.6992,160550,0.611,228,402,293,165,536,383,180,98,82,919
P53312,46900.67,109.838,7.4212,21890,0.689,124,211,132,36,225,202,120,64,56,427
P41734,27346.25,114.900,5.3968,38390,,54,100,67,34,130,108,67,33,34,238
P20967,114416.30,112.837,7.2008,144160,0.718,282,487,267,135,508,506,277,153,124,1014
P04710,34120.53,110.422,10.1632,38850,0.738,105,149,94,41,183,126,65,42,23,309
P35202,36616.09,114.784,6.2425,37360,0.614,74,147,91,36,160,159,84,43,41,319
P54857,37500.18,115.031,8.4398,55350,0.819,76,158,85,44,167,159,86,49,37,326
P22768,46927.67,111.733,5.2505,47330,0.502,117,215,125,41,227,193,115,56,59,420
P21524,99561.16,112.118,6.0952,119070,0.609,263,447,253,101,471,417,220,112,108,888
P50264,57805.61,113.791,5.3764,63370,,128,245,144,59,261,247,136,67,69,508
P07286,50368.04,112.429,8.4486,72310,0.770,112,204,166,68,306,142,78,47,31,448
P00925,46914.17,107.355,5.8449,42400,0.570,144,243,151,40,240,197,117,59,58,437
Q07824,64272.25,109.680,6.8501,88240,0.691,187,303,206,86,395,191,96,52,44,586
Q12246,69639.31,111.601,6.3794,52830,0.794,167,322,166,58,307,317,165,85,80,624
P00425,17196.73,113.886,10.4315,38960,0.818,42,69,38,16,77,74,39,24,15,151
P25515,16350.60,102.191,7.9140,8940,0.825,63,90,74,14,124,36,12,7,5,160
P41930,52545.22,114.728,8.5474,107720,0.748,122,202,155,81,300,158,67,41,26,458
P32178,29747.17,116.200,6.1610,20400,0.576,49,107,73,29,127,129,83,42,41,256
P42941,34207.28,110.703,4.8255,17420,,82,153,100,24,161,148,86,40,46,309
P22855,124499.02,114.958,7.2317,211540,0.730,277,515,261,158,540,543,294,159,135,1083
P39004,62735.08,110.062,7.7273,108750,0.771,186,295,187,79,366,204,96,52,44,570
Q04952,207483.45,116.237,8.1428,335190,0.691,436,746,515,312,1022,763,393,220,173,1785
P17695,15861.47,110.919,7.1343,4470,0.654,38,67,48,12,75,68,34,18,16,143
Q07923,21280.60,111.417,6.0036,26930,0.498,44,92,69,16,108,83,49,25,24,191
P31688,102976.25,114.929,8.2311,164670,0.715,217,426,239,105,433,463,247,135,112,896
P07807,24261.00,114.981,7.7655,25440,0.781,46,93,53,24,111,100,60,32,28,211
P43567,41907.18,108.850,7.9974,42400,0.810,124,210,126,44,218,167,84,48,36,385
P43581,60662.04,111.103,9.0886,105770,0.872,177,274,171,79,351,195,85,50,35,546
P38824,17317.74,114.687,7.5775,24410,0.953,49,89,16,15,53,98,41,21,20,151
Q12119,57327.31,108.165,4.8428,114250,0.684,185,288,194,79,363,167,73,34,39,530
P32621,56821.62,109.694,4.9793,45840,0.665,156,278,146,53,280,238,124,59,65,518
Q03674,75455.46,106.877,4.2810,94770,0.815,281,443,188,67,355,351,115,46,69,706
P40029,21140.87,114.896,6.9405,34380,0.644,50,88,41,27,91,93,56,30,26,184
P40017,103333.83,111.954,6.2408,75750,0.676,265,482,241,98,424,499,257,133,124,923
P12685,141073.29,114.229,8.7381,153560,0.850,332,611,280,154,552,683,358,203,155,1235
P00498,32266.41,108.641,5.9234,12950,0.616,90,159,105,18,163,134,76,38,38,297
Q05874,29632.61,113.535,4.7771,35410,,56,120,78,36,138,123,76,35,41,261
P38122,34464.91,110.464,8.1418,31400,0.777,99,159,88,31,166,146,68,38,30,312
Q04409,55920.88,111.842,6.2004,37820,0.587,144,237,147,52,261,239,134,69,65,500
P53095,47827.84,111.747,7.5537,46870,0.785,125,219,121,48,221,207,100,56,44,428
P53296,61898.06,115.697,5.7272,71170,0.511,126,240,138,87,276,259,143,72,71,535
P21147,58402.98,114.516,9.3128,118260,0.778,136,233,142,85,279,231,132,81,51,510
P22108,36840.80,113.356,5.2317,31400,,77,163,82,40,160,165,92,45,47,325
P16451,45361.75,110.638,5.4055,21890,0.615,111,207,124,32,200,210,116,57,59,410
P38620,34764.95,109.324,6.4227,11920,0.533,94,168,113,27,172,146,81,43,38,318
P38218,19937.82,112.643,7.5801,28880,0.857,53,81,44,23,95,82,44,24,20,177
P38226,45515.17,114.648,9.7986,76320,0.834,97,167,128,56,220,177,95,59,36,397
P17261,30116.30,115.832,8.7972,75860,0.815,68,117,80,47,161,99,39,25,14,260
P46681,59268.42,111.827,6.0049,56730,0.726,134,261,154,61,282,248,138,70,68,530
Q12051,38651.44,115.377,6.0388,27390,0.499,64,137,106,39,167,168,83,43,40,335
P00431,40352.97,111.781,6.3124,73340,0.757,110,191,88,53,188,173,93,48,45,361
P40581,18641.50,114.365,8.2148,17420,0.812,36,69,37,22,87,76,47,25,22,163
P25605,33986.74,109.989,6.4957,12950,0.649,95,164,101,22,156,153,77,41,36,309
P37020,87591.67,112.441,7.0730,110700,0.644,228,369,255,105,450,329,163,87,76,779
Q07830,115634.49,113.702,6.6121,168680,0.600,259,459,341,155,590,427,191,104,87,1017
P04807,53942.47,110.993,4.9256,45840,0.571,134,241,134,49,265,221,125,59,66,486
P40559,108429.64,114.619,6.6922,138550,0.662,234,433,257,124,475,471,269,140,129,946
Q06592,18333.62,117.523,5.0183,42400,,34,74,36,27,79,77,46,22,24,156
P19657,102171.98,107.890,4.6577,116770,,315,512,340,88,556,391,207,93,114,947
Q05902,73180.44,110.879,5.7138,87320,0.664,185,342,193,74,358,302,165,83,82,660
P47026,55466.32,113.197,9.6816,90760,0.880,139,229,168,74,300,190,71,46,25,490
P00931,76626.06,108.382,6.4664,55810,0.647,226,384,221,75,392,315,173,91,82,707
P38689,35123.74,109.762,8.3388,8940,0.702,91,168,119,20,173,147,85,47,38,320
P50095,56584.78,108.193,7.3439,24870,0.810,171,278,153,41,283,240,115,61,54,523
P11986,59642.06,111.899,5.7118,53290,0.660,132,272,161,54,279,254,132,66,66,533
P33315,75029.41,110.175,6.0484,92710,0.705,210,355,189,86,367,314,168,86,82,681
P07170,24254.76,109.256,6.3466,15470,0.600,62,112,68,15,118,104,64,33,31,222
Q04179,37960.38,111.648,5.0701,48360,0.574,92,173,99,45,197,143,81,39,42,340
Q06892,46246.87,111.707,9.3826,35410,0.914,110,217,114,45,206,208,100,60,40,414
P53306,70354.43,115.525,9.3955,79650,0.856,141,261,198,95,352,257,112,70,42,609
P48836,12712.67,111.515,9.6567,2980,0.514,27,44,39,5,50,64,47,26,21,114
P53264,52044.68,116.954,9.9651,87320,0.872,98,193,109,70,229,216,128,79,49,445
P36001,48143.42,111.961,7.1014,45380,0.700,121,212,139,38,224,206,100,54,46,430
P49095,114451.25,110.688,7.2395,78160,0.757,300,520,314,108,551,483,248,139,109,1034
Q03266,42639.79,114.010,5.5275,38850,0.596,96,176,102,37,189,185,99,49,50,374
Q12209,78948.51,115.085,9.4179,103710,0.869,167,311,206,110,381,305,159,103,56,686
P53961,26816.74,117.104,10.7125,15930,0.534,42,86,74,28,124,105,57,38,19,229
P33893,61868.83,114.360,7.6533,47790,0.695,125,234,157,62,267,274,146,81,65,541
P0CZ17,38686.58,106.869,4.4393,44810,0.702,131,207,113,37,209,153,64,27,37,362
P42837,101746.11,115.752,5.4640,144050,,212,406,226,128,435,444,242,120,122,879
P32614,50844.09,108.179,6.2515,22920,0.717,143,251,151,36,251,219,115,59,56,470
P25641,58435.05,112.375,5.2459,100270,0.502,168,275,130,70,280,240,131,64,67,520
P00572,24687.38,114.293,5.4106,25440,,49,95,61,22,108,108,65,32,33,216
Q03778,24537.09,112.555,4.8398,20400,,51,112,66,28,126,92,47,22,25,218
P48016,136920.61,113.064,5.0696,195850,0.699,309,625,337,159,618,593,274,132,142,1211
Q01896,120317.25,110.282,5.1940,125250,0.592,329,585,338,113,587,504,255,124,131,1091
P06775,66006.36,109.463,7.3419,93850,0.789,203,320,204,74,361,242,108,58,50,603
P49954,32549.23,111.853,7.4741,21890,0.752,79,145,85,34,153,138,76,42,34,291
P31382,86869.75,114.453,7.6969,199160,0.783,210,365,210,133,442,317,154,88,66,759
Q04902,26039.60,109.872,8.0517,25900,0.775,76,124,72,33,132,105,61,34,27,237
P25340,56039.68,118.477,8.7096,166620,0.689,111,192,131,112,308,165,89,57,32,473
P53199,38706.37,110.907,6.6554,47900,0.645,91,187,108,42,198,151,88,47,41,349
P54839,55013.53,112.044,8.2337,63720,0.761,140,250,137,58,253,238,124,68,56,491
P53744,62428.12,111.280,7.2715,84800,0.787,178,286,183,88,353,208,80,45,35,561
P47165,23671.16,113.259,6.1520,25440,,50,92,66,20,108,101,62,32,30,209
P53078,31968.69,114.174,6.3358,23380,,64,127,87,35,146,134,76,40,36,280
P21592,52147.66,112.874,10.3254,97290,0.767,138,227,139,66,268,194,86,63,23,462
P54862,62732.71,110.640,8.5515,108750,0.843,189,294,173,85,353,214,88,50,38,567
P38791,42892.20,110.833,5.4899,45380,0.511,109,195,115,38,211,176,109,54,55,387
P00817,32299.59,112.542,5.2462,49390,0.514,71,145,80,34,148,139,84,41,43,287
P53319,53922.83,109.599,7.2463,66350,0.701,154,249,159,55,286,206,124,67,57,492
P38075,26908.26,118.019,7.3589,47440,0.593,52,100,52,30,103,125,78,41,37,228
P15496,33351.54,115.804,4.6097,47440,,63,131,70,37,138,150,88,39,49,288
P32875,46247.14,111.708,10.0508,42400,0.758,128,218,108,30,202,212,122,74,48,414
P47039,50082.38,112.798,6.5055,55810,0.678,118,213,135,55,242,202,105,54,51,444
P07255,6963.22,118.021,10.3817,19480,,14,22,16,9,34,25,17,11,6,59
Q01217,94869.27,109.930,8.3813,93170,0.820,255,451,279,86,463,400,206,113,93,863
P27515,56296.13,112.368,7.6850,48360,0.725,122,246,166,51,272,229,127,70,57,501
P06115,64583.35,114.917,6.5034,86180,0.689,136,278,124,89,282,280,146,77,69,562
Q06350,59117.98,115.691,8.2724,92710,0.860,121,230,119,87,257,254,135,77,58,511
P38995,109828.91,109.391,4.7947,88240,0.524,318,531,332,92,564,440,210,97,113,1004
P40047,56692.85,109.025,8.2075,55350,0.750,163,284,166,53,289,231,127,69,58,520
Q12675,182618.56,113.287,6.0347,200430,0.644,429,800,453,180,822,790,430,217,213,1612
P00410,28567.20,113.814,4.1958,48360,,60,114,89,36,157,94,48,18,30,251
P49090,64593.22,112.925,5.6877,93280,,159,279,163,78,307,265,171,86,85,572
P38708,77386.25,112.480,6.3413,97290,0.592,182,337,195,78,359,329,193,99,94,688
P00856,5822.26,121.297,10.2568,4470,,6,12,18,10,36,12,3,3,0,48
Q04119,78344.31,116.238,6.8302,100730,0.654,139,302,163,86,325,349,219,114,105,674
P04161,23540.17,110.001,6.3786,19940,,60,101,77,18,118,96,57,30,27,214
P30605,63569.70,108.852,6.4950,66350,0.710,197,300,200,68,352,232,98,51,47,584
P35172,89679.34,114.974,6.4285,137520,0.650,198,364,198,112,405,375,218,113,105,780
P39976,55225.00,111.341,6.8602,44810,0.722,130,253,147,60,266,230,132,71,61,496
P38631,214850.95,114.526,7.2122,351010,0.639,505,854,544,294,1087,789,416,227,189,1876
P08465,53659.50,110.410,5.3458,67840,0.647,159,254,141,50,248,238,112,55,57,486
P43548,61051.86,109.412,7.4425,106230,0.767,177,290,212,83,370,188,91,50,41,558
P0CX11,47327.58,108.301,4.9388,48360,0.520,142,233,144,41,244,193,110,52,58,437
Q12031,64975.92,113.002,7.5222,89840,0.725,169,278,151,70,284,291,157,85,72,575
P32331,33375.68,108.716,9.8437,21430,0.893,102,158,94,32,180,127,63,40,23,307
P53982,47856.37,113.944,9.7859,39880,0.746,104,185,115,44,208,212,128,73,55,420
Q08645,62151.44,113.415,9.2195,70360,0.790,147,255,154,64,273,275,147,84,63,548
P04802,63515.52,114.031,6.5231,32320,,131,239,160,59,279,278,186,96,90,557
P53838,65027.67,112.895,7.8158,61310,0.733,159,277,181,88,340,236,107,60,47,576
P23202,40270.77,113.759,6.4306,49390,0.809,87,184,93,47,170,184,77,41,36,354
P41921,53440.91,110.644,7.8226,50310,0.751,136,247,144,55,255,228,134,75,59,483
P23500,33307.49,109.564,7.9848,42400,0.750,107,155,98,38,180,124,54,32,22,304
Q12452,39724.75,114.481,8.4791,54780,0.703,79,165,108,47,192,155,79,42,37,347
P06633,23833.17,108.333,6.3599,6990,,71,111,76,22,118,102,63,34,29,220
P34756,257419.66,113.002,8.5380,216710,0.897,651,1177,526,240,968,1310,603,340,263,2278
P40260,54202.12,110.167,5.2437,125250,0.665,168,256,159,74,312,180,84,41,43,492
Q06490,63298.02,110.661,5.6784,54780,0.506,169,298,182,55,322,250,140,70,70,572
Q02979,138014.26,112.849,6.7588,120670,0.683,312,587,368,130,600,623,334,179,155,1223
Q08742,16697.38,112.063,10.2594,12950,0.691,40,74,41,17,78,71,45,29,16,149
P38156,68262.85,111.177,5.4490,126740,0.657,199,304,191,79,373,241,122,60,62,614
P40884,67556.90,116.277,5.1839,136250,0.549,138,272,119,100,296,285,173,84,89,581
P33412,36862.79,114.126,6.4335,43320,,86,165,83,44,160,163,98,52,46,323
P15454,20637.37,110.360,6.9894,14440,0.783,58,97,51,19,93,94,53,27,26,187
P46961,32577.33,116.348,9.7644,71850,0.807,72,125,97,44,161,119,46,28,18,280
P50076,61792.69,117.700,9.6959,117230,0.750,112,209,173,103,338,187,83,56,27,525
P53204,44909.07,113.694,5.7441,40340,0.581,93,189,108,43,200,195,107,54,53,395
P38295,51255.25,113.648,7.7624,74830,0.755,120,226,119,62,236,215,121,66,55,451
P16639,57930.44,115.170,6.2430,86180,0.590,123,226,127,73,278,225,138,71,67,503
P39932,63531.84,111.655,6.4987,84800,0.695,184,279,168,83,328,241,110,57,53,569
P38693,52699.72,112.847,4.7727,80220,0.528,144,251,115,70,236,231,106,49,57,467
P07250,40353.01,113.670,4.3342,31860,,86,170,89,35,162,193,120,49,71,355
Q04082,16089.64,114.926,3.9502,35410,,38,63,43,19,82,58,25,8,17,140
P53322,60134.92,112.612,6.7967,81250,0.680,154,256,162,79,323,211,107,56,51,534
P38149,98070.84,111.698,5.2179,128230,0.669,250,436,254,98,437,441,197,96,101,878
P00812,35661.94,107.093,5.3741,32890,0.623,105,183,108,30,197,136,81,40,41,333
Q02784,16931.45,112.876,4.5414,11460,,38,67,44,14,84,66,42,18,24,150
Q07729,55203.59,112.891,5.8915,53860,,132,249,132,56,240,249,130,66,64,489
Q08959,37069.78,115.482,8.8776,73910,0.575,75,139,109,48,187,134,86,51,35,321
Q00055,42868.83,109.639,5.1625,47900,,117,202,126,43,221,170,97,47,50,391
P32375,50126.31,108.970,5.8459,47900,0.636,144,250,137,47,257,203,104,53,51,460
Q12473,81989.20,115.153,9.1106,128690,0.838,178,316,227,130,408,304,146,95,51,712
P27810,46022.07,117.105,6.6615,100730,0.560,99,180,91,81,211,182,115,62,53,393
P32190,79824.33,112.587,8.0733,124790,0.761,204,349,198,82,376,333,179,98,81,709
P43636,58047.10,115.402,6.1973,75750,,113,212,159,79,283,220,121,62,59,503
P39535,97688.59,110.884,7.0623,107720,0.655,257,429,306,102,506,375,186,98,88,881
P39708,49627.16,108.593,5.1221,55350,0.704,152,245,134,46,252,205,106,51,55,457
P08019,61462.97,111.954,4.6654,107260,0.543,159,284,158,82,300,249,108,49,59,549
P20051,40313.31,110.751,6.4989,31400,0.574,95,187,116,44,201,163,96,51,45,364
Q05521,33514.01,115.965,6.4054,45380,0.534,65,125,89,49,174,115,62,33,29,289
P25621,58256.48,113.782,7.1801,111840,0.710,141,246,159,79,305,207,101,55,46,512
P32449,39749.13,107.430,6.9005,21430,0.769,120,204,118,26,199,171,90,48,42,370
P32477,78253.60,115.418,6.2144,105200,0.583,157,323,174,99,343,335,198,102,96,678
P41807,54415.83,113.841,6.2947,43890,,105,206,165,44,235,243,130,67,63,478
Q12010,34872.56,113.223,4.5282,56380,0.644,71,146,106,44,193,115,46,20,26,308
P38913,35546.16,116.164,4.9502,60850,0.513,76,133,78,49,160,146,74,35,39,306
P25345,56784.91,115.416,8.5850,73800,0.808,128,217,121,72,244,248,122,71,51,492
Q12428,57683.63,111.790,9.5028,52830,0.779,139,252,167,58,279,237,134,80,54,516
P08679,51413.31,111.768,6.3261,65780,0.670,124,224,138,57,244,216,121,63,58,460
Q05779,29958.47,115.225,9.0752,30370,0.825,66,110,68,41,133,127,70,43,27,260
Q06708,99772.54,113.378,5.1554,69220,0.535,211,400,282,82,444,436,223,108,115,880
P00549,54544.63,109.089,7.6343,27850,0.714,149,280,163,38,271,229,128,68,60,500
P47081,14077.06,119.297,9.3500,23950,0.736,25,42,29,18,57,61,40,22,18,118
P53144,25296.96,117.660,5.4232,33920,,44,88,56,24,102,113,73,36,37,215
P30624,77866.30,111.238,7.6099,95230,0.725,197,351,207,77,374,326,179,98,81,700
P27472,80078.85,113.587,6.3061,87210,0.497,174,345,208,97,379,326,201,105,96,705
Q12166,67200.21,111.259,6.7352,66810,0.718,172,317,178,62,311,293,157,83,74,604
P32463,13942.68,111.541,4.5657,4470,,34,68,40,9,59,66,34,15,19,125
P31412,44188.53,112.726,6.6218,37360,0.627,99,188,127,45,199,193,102,53,49,392
P42884,41991.00,111.678,6.7041,68870,0.702,109,180,109,44,206,170,99,52,47,376
Q08777,57582.18,110.522,5.4112,83770,0.638,179,274,158,82,314,207,91,45,46,521
P32582,56021.89,110.497,6.6301,45840,0.731,135,259,157,44,256,251,142,73,69,507
P28272,34800.93,110.831,5.8461,17880,0.777,85,154,89,35,175,139,74,37,37,314
P19358,42255.92,110.041,4.9829,44350,,118,199,115,38,206,178,107,51,56,384
P53934,45496.79,113.742,5.8497,65780,0.702,108,190,105,54,216,184,95,48,47,400
P00401,58798.11,110.109,7.0819,90760,0.773,162,265,199,94,367,167,57,35,22,534
Q07500,61659.25,113.136,9.0386,71280,0.716,144,254,163,63,293,252,134,73,61,545
P40857,24510.66,112.952,10.3670,38850,0.583,55,91,92,31,150,67,25,21,4,217
Q99288,39172.07,117.282,7.2900,44350,0.654,72,154,76,47,155,179,111,61,50,334
P53730,62672.48,113.743,7.0568,89270,0.605,142,253,186,89,335,216,99,54,45,551
P38360,131875.00,108.450,7.5182,68760,0.798,421,669,375,98,627,589,291,161,130,1216
P47016,34692.86,113.006,6.8270,36440,0.652,72,140,95,29,158,149,89,48,41,307
P40988,62791.99,113.754,5.1649,116310,,148,267,169,73,311,241,130,63,67,552
P07244,86068.03,107.317,4.8920,59820,0.547,248,455,269,71,462,340,176,83,93,802
Q3E790,9579.26,119.741,8.8352,14440,0.698,19,28,21,20,47,33,17,11,6,80
P15700,22933.20,112.418,6.4810,5960,0.606,54,98,57,18,101,103,63,32,31,204
P32906,63057.35,114.859,5.4564,117690,,151,251,141,89,289,260,141,70,71,549
P38703,48454.50,117.894,9.1474,96260,0.680,94,172,124,80,240,171,91,54,37,411
P38138,110266.09,115.583,6.0950,168110,0.573,223,446,245,158,490,464,243,126,117,954
P47771,55187.89,109.067,5.2373,58330,0.657,159,274,155,56,282,224,115,56,59,506
P38604,83460.42,114.173,6.5810,153100,0.642,202,345,197,119,415,316,173,92,81,731
P47095,27426.85,112.405,6.5704,24410,0.549,63,116,69,31,139,105,63,34,29,244
P36136,31021.96,114.472,5.8304,42400,,67,125,72,32,138,133,81,41,40,271
P53868,63776.75,114.913,8.7166,128230,0.823,135,250,187,99,353,202,92,56,36,555
P00358,35846.85,107.972,6.9153,31400,0.670,108,193,110,32,180,152,84,45,39,332
Q06625,174971.61,113.914,5.5251,264720,0.618,387,754,412,216,810,726,406,202,204,1536
P40012,59702.86,110.766,9.7956,44350,0.937,145,276,150,46,283,256,134,79,55,539
Q08108,75077.03,109.442,4.6250,88810,0.788,229,397,186,79,358,328,127,57,70,686
P48527,55287.42,112.373,9.5156,44810,0.890,132,239,146,52,254,238,119,70,49,492
P00445,15854.60,102.952,5.9054,1490,0.795,58,100,42,13,83,71,39,20,19,154
Q06703,35693.15,114.401,5.0270,61420,,79,153,82,46,156,156,81,39,42,312
P32419,37186.16,108.414,9.7872,10430,0.884,96,176,117,26,188,155,83,48,35,343
Q12122,48594.25,110.441,6.2385,23380,0.555,123,237,140,42,226,214,126,65,61,440
Q12524,39754.80,116.926,6.5744,59360,0.591,69,136,86,50,180,160,106,56,50,340
P42826,68320.92,113.868,6.7995,71280,0.663,155,286,163,69,296,304,165,88,77,600
P10869,58109.72,110.265,6.6305,28880,0.666,150,272,170,47,275,252,133,70,63,527
Q08409,157751.07,113.164,7.1773,215330,0.706,403,673,410,217,779,615,281,152,129,1394
P53048,67980.26,110.358,5.2716,116770,0.699,209,308,197,71,361,255,111,54,57,616
P38625,58482.23,111.395,6.4603,59360,0.559,138,254,162,59,288,237,142,75,67,525
P47052,69382.45,109.436,7.3505,62800,0.702,213,340,182,71,336,298,169,96,73,634
P38426,118835.11,112.747,6.3172,125140,0.718,286,536,294,128,512,542,267,139,128,1054
P22133,40730.77,108.039,6.8737,14900,0.839,108,206,129,30,210,167,76,42,34,377
Q04432,25669.85,108.312,5.1371,22920,,76,137,71,30,128,109,66,32,34,237
P53090,56177.88,112.356,5.8542,76780,0.687,132,248,137,65,271,229,125,63,62,500
P53394,83384.06,110.589,8.3659,51230,0.893,230,395,234,86,416,338,139,78,61,754
P36010,17166.67,112.200,8.8861,26470,0.789,41,73,43,17,81,72,45,25,20,153
P28834,39324.03,109.233,9.5263,22920,0.791,111,186,114,32,189,171,94,54,40,360
Q07747,36977.04,112.392,6.7735,63370,0.635,95,157,93,42,172,157,90,48,42,329
Q05871,31698.42,113.209,8.2058,30370,0.840,72,132,80,36,152,128,69,38,31,280
P38127,42101.63,111.675,10.1425,66350,0.818,117,178,106,44,203,174,88,56,32,377
P14904,57092.67,111.075,5.6312,55350,0.615,141,257,145,61,271,243,140,70,70,514
Q04089,66201.32,113.748,9.4523,48250,0.925,149,283,141,59,265,317,163,95,68,582
P07283,29062.91,114.421,4.8826,24410,,63,113,65,35,130,124,77,36,41,254
P38698,45051.40,113.480,5.3859,37360,0.555,91,180,120,39,198,199,118,58,60,397
Q99271,109369.11,111.035,5.1549,115280,0.673,291,494,279,89,510,475,267,129,138,985
Q99297,34006.92,110.772,10.2204,35870,0.733,92,155,92,32,181,126,64,42,22,307
P38142,53525.98,109.684,7.1476,96260,0.751,167,247,169,69,310,178,70,39,31,488
P40471,32813.94,110.485,9.6049,21890,0.879,85,152,92,32,168,129,72,42,30,297
P32340,57249.87,111.598,9.9576,48820,0.881,141,245,160,61,275,238,127,76,51,513
P53915,27689.58,115.373,6.6441,36900,0.507,51,115,67,33,118,122,77,40,37,240
P00420,30359.71,112.861,7.0448,71850,0.524,79,127,101,55,184,85,36,24,12,269
P52489,55195.22,109.081,6.8783,21890,0.668,153,269,171,40,275,231,122,65,57,506
Q12040,26176.58,113.811,7.9134,17420,0.664,59,107,61,28,106,124,74,43,31,230
P26364,25193.97,111.973,9.3966,22920,0.785,61,103,69,18,114,111,62,34,28,225
P00724,60639.31,113.984,4.3598,134190,0.609,154,285,121,90,277,255,105,43,62,532
Q08689,19726.74,112.084,7.8536,14440,0.711,42,84,55,24,95,81,46,27,19,176
P26263,61580.43,109.379,6.1049,63830,0.646,166,290,189,60,311,252,123,63,60,563
P48445,76362.96,110.671,6.8886,75180,0.820,199,369,198,86,383,307,135,73,62,690
P09950,59362.27,108.325,7.4865,44350,0.738,184,299,179,61,294,254,133,77,56,548
Q08269,95869.24,111.606,6.6711,74260,0.798,267,459,208,90,389,470,227,121,106,859
P36973,19985.97,110.420,4.5781,4470,,49,82,62,25,107,74,48,21,27,181
P53390,53689.84,109.795,6.4860,129260,0.681,174,259,163,77,314,175,77,41,36,489
P36014,19484.56,116.674,8.4672,15930,0.876,30,71,38,25,89,78,45,26,19,167
P10356,49490.22,111.716,6.6563,46300,0.751,136,222,121,53,237,206,100,53,47,443
Q07540,19490.16,112.012,5.6273,16960,0.567,45,87,52,16,88,86,48,24,24,174
P15019,37036.40,110.556,6.3080,27390,0.540,98,165,108,30,171,164,97,49,48,335
P04076,51989.13,112.288,5.4824,51340,,133,215,134,54,243,220,131,65,66,463
Q12325,99650.78,111.591,6.6421,156080,0.752,260,473,273,121,502,391,192,101,91,893
Q12520,38075.48,112.317,10.3178,65890,0.670,96,153,114,44,209,130,54,39,15,339
P07806,125769.79,113.922,6.9387,189650,0.601,272,511,310,127,553,551,340,179,161,1104
P12684,115691.93,110.710,7.5673,101080,0.754,311,527,354,114,588,457,212,117,95,1045
P40215,62774.18,112.097,9.7302,78730,0.815,157,276,176,65,300,260,144,83,61,560
Q06005,37237.30,113.528,9.6451,14440,0.742,84,155,89,25,158,170,87,52,35,328
P25374,54467.04,109.592,8.2405,41830,0.765,164,264,154,51,264,233,129,74,55,497
P23776,51310.97,114.533,4.3418,122730,,120,225,116,71,237,211,110,45,65,448
P39683,49018.60,114.262,6.8895,71280,0.688,112,199,112,60,212,217,120,64,56,429
P38840,58527.61,114.089,5.1555,73800,0.642,132,247,134,66,265,248,126,61,65,513
Q12746,35287.26,113.100,5.2263,51800,0.537,76,151,96,40,173,139,80,39,41,312
P05150,37845.22,111.968,6.2345,11460,0.562,94,168,100,38,167,171,89,46,43,338
Q01926,54202.81,115.325,9.9037,56840,0.848,114,212,137,49,222,248,117,70,47,470
P32179,39149.28,109.662,6.1276,31400,0.590,109,187,111,37,184,173,97,50,47,357
P00424,17140.49,112.029,10.4180,38960,0.871,48,76,41,16,79,74,34,21,13,153
P41735,26059.69,111.844,7.9310,26930,0.639,71,112,73,30,121,112,63,38,25,233
P38242,27035.17,114.072,10.1720,36900,0.588,60,97,83,35,143,94,53,37,16,237
P00924,46816.14,107.131,6.5827,40910,0.660,144,242,151,41,240,197,118,62,56,437
P09368,53271.44,111.915,9.2968,44810,0.905,120,227,147,48,251,225,104,61,43,476
P40975,4848.00,112.744,12.0588,6990,,12,16,19,4,31,12,5,5,0,43
P46971,87966.29,115.441,6.9207,184610,0.580,190,354,226,148,447,315,172,96,76,762
P33300,44808.05,117.299,9.2619,85260,0.810,87,159,105,64,207,175,102,61,41,382
P36148,83644.90,112.577,9.9946,62230,0.843,196,360,231,86,394,349,191,118,73,743
P30777,72565.82,117.802,8.5581,130180,0.656,135,237,190,129,371,245,137,79,58,616
P53008,96506.93,115.855,4.7038,165590,,190,370,209,127,432,401,225,102,123,833
P19881,34624.58,110.976,6.2667,30370,0.734,91,156,87,36,170,142,73,37,36,312
P07347,27603.17,115.980,4.5179,23380,,48,104,69,24,114,124,74,32,42,238
Q03835,28261.34,113.045,4.0965,18450,,62,117,65,28,117,133,72,25,47,250
Q04396,31586.27,115.278,8.3269,53400,0.759,67,126,87,39,162,112,60,36,24,274
P36088,19734.30,109.635,4.6862,25440,,55,95,54,22,97,83,42,19,23,180
P53332,34306.52,112.480,6.2760,26930,0.564,78,143,91,31,159,146,78,41,37,305
Q02948,63260.87,113.574,4.6904,39880,0.608,134,265,148,38,227,330,148,67,81,557
P32785,44616.72,111.264,10.1766,21430,0.801,115,198,125,34,219,182,98,62,36,401
P08536,57724.51,112.964,5.6163,61310,0.528,122,245,158,61,275,236,136,68,68,511
P32383,100547.55,115.705,9.5499,91220,0.834,206,375,228,109,411,458,244,146,98,869
Q03034,56163.90,111.658,6.0005,63830,0.505,134,245,151,60,286,217,133,68,65,503
P48567,45273.39,112.341,6.5192,28880,0.570,105,187,111,34,184,219,130,67,63,403
P17255,118636.69,110.772,6.0508,119070,0.646,326,550,310,114,567,504,288,146,142,1071
P32467,63910.07,110.955,6.6162,110240,0.724,183,299,174,86,363,213,101,52,49,576
P32459,21726.71,111.419,5.0629,18450,,55,100,56,20,100,95,48,23,25,195
Q06178,45859.05,114.362,6.8757,40340,0.622,92,184,109,51,197,204,127,71,56,401
P28777,40838.31,108.613,7.7442,11920,0.839,124,204,98,33,196,180,99,54,45,376
P30952,62791.13,113.341,7.1522,72310,0.684,132,270,165,62,297,257,140,76,64,554
P08431,42385.10,115.806,7.5234,60850,0.752,84,168,95,53,182,184,97,55,42,366
Q12184,18932.46,110.072,5.5555,5960,,57,92,45,15,85,87,46,23,23,172
P39726,18793.02,110.547,4.3768,25440,,50,89,47,15,85,85,42,17,25,170
Q07804,66507.89,116.070,6.6216,102790,0.567,128,264,158,94,295,278,156,84,72,573
P39525,47555.21,107.591,8.1797,24410,0.929,154,244,134,39,236,206,91,53,38,442
P40553,24119.64,112.184,9.9822,5960,0.874,54,103,60,17,100,115,69,40,29,215
P46151,73941.61,112.544,5.0214,98780,,185,312,187,81,343,314,180,86,94,657
P40009,71851.94,114.051,6.1726,87320,0.686,170,302,151,91,317,313,169,87,82,630
P29952,48188.73,112.328,5.8235,27390,0.611,104,206,115,49,220,209,125,63,62,429
P53852,87530.25,114.120,6.8232,108290,0.643,186,358,205,89,360,407,223,117,106,767
P15807,31917.74,116.488,6.2444,31400,,53,114,77,32,144,130,88,45,43,274
P54114,55385.29,109.457,5.4203,51340,0.656,154,269,152,54,279,227,122,60,62,506
P39540,36233.87,116.883,9.6869,87780,0.581,76,136,104,61,200,110,54,38,16,310
P52911,63508.15,113.004,5.0118,132240,0.599,172,289,152,83,283,279,115,55,60,562
P39979,18814.39,116.860,6.6500,43890,,37,76,46,27,86,75,49,26,23,161
Q04212,38220.43,114.091,5.2787,40340,0.560,83,155,98,42,175,160,88,43,45,335
P0CD98,16456.33,108.265,8.9997,36440,0.774,58,78,56,22,106,46,20,13,7,152
P36035,69376.26,112.624,5.7126,131210,0.528,181,293,200,94,380,236,128,64,64,616
P10174,6932.37,115.539,11.1633,16960,,14,25,24,10,40,20,10,10,0,60
P38707,62206.82,112.287,5.5913,56270,,158,264,158,59,286,268,161,80,81,554
P53154,65339.91,116.678,9.8168,140720,0.779,132,233,196,105,346,214,109,71,38,560
P14843,41069.91,111.000,7.3283,26930,0.744,103,179,102,29,187,183,113,60,53,370
P39109,171121.36,112.951,8.5388,210970,0.734,405,699,506,184,843,672,328,185,143,1515
Q06389,22010.98,115.847,4.6402,21430,,46,83,44,29,95,95,58,26,32,190
P08425,54828.87,116.906,8.0120,77350,0.679,98,206,120,58,222,247,148,82,66,469
P32473,40053.64,109.436,4.9531,23380,0.518,114,195,121,37,206,160,89,42,47,366
P53823,25208.00,113.550,7.0838,19940,0.544,53,104,70,28,118,104,60,33,27,222
Q08686,34218.98,112.562,5.9202,50880,0.695,79,158,79,42,166,138,83,42,41,304
Q08485,67193.47,112.364,7.6760,157680,0.823,202,307,168,109,368,230,89,51,38,598
Q12375,31519.65,107.944,9.7231,29450,0.865,102,150,99,32,171,121,58,36,22,292
P38972,148904.96,109.650,4.9192,139690,0.648,411,709,401,127,733,625,312,147,165,1358
Q03020,17895.08,108.455,10.1724,5960,0.753,52,89,55,11,93,72,41,27,14,165
Q12674,188319.28,113.719,6.7343,207880,0.692,442,801,449,186,810,846,433,227,206,1656
Q04958,187132.83,111.455,8.1865,172930,0.870,512,861,451,194,815,864,382,218,164,1679
Q08361,15721.94,109.944,6.4774,9970,0.703,42,73,44,13,76,67,39,20,19,143
P38994,89320.45,114.660,9.7721,62690,0.925,199,384,174,97,325,454,229,142,87,779
P32791,78853.77,114.947,9.4838,137170,0.819,187,321,205,111,388,298,147,94,53,686
P53318,53527.45,111.748,6.9705,55810,0.740,131,248,146,50,261,218,117,62,55,479
P41338,41728.69,104.846,7.3259,26930,0.776,140,232,146,28,232,166,88,47,41,398
P54885,49740.49,109.080,5.2539,32890,,138,237,154,38,235,221,129,63,66,456
Q08985,36668.58,112.826,4.8803,50880,0.650,85,159,89,38,170,155,79,37,42,325
P38790,33055.10,118.054,8.8727,41830,0.793,58,118,70,40,144,136,74,44,30,280
P52867,84775.93,114.099,7.8886,158600,0.752,201,350,233,139,447,296,143,85,58,743
Q04458,59978.96,112.742,6.7188,51800,0.715,136,255,156,67,289,243,131,69,62,532
P27514,99490.36,111.287,8.0351,101300,0.818,257,444,292,100,491,403,153,88,65,894
P36143,69724.00,113.188,3.9837,70820,,153,327,139,62,255,361,169,55,114,616
P15274,93301.64,115.187,6.5875,117580,0.624,185,391,210,114,384,426,237,127,110,810
P16603,76771.79,111.102,4.8025,67730,0.580,187,365,202,81,367,324,166,77,89,691
P38697,56529.90,108.088,8.6092,24870,0.861,171,282,155,39,284,239,115,64,51,523
P32874,259163.40,114.018,8.9400,277100,0.789,548,1024,663,259,1172,1101,624,350,274,2273
P38074,39786.12,114.328,5.1518,45840,,82,164,91,50,176,172,103,50,53,348
P62651,8039.40,118.226,4.7023,31970,,19,30,23,14,45,23,11,5,6,68
P09201,38262.58,109.950,5.8632,24410,0.670,103,183,104,39,192,156,81,41,40,348
P47164,72350.57,113.225,5.8795,57760,0.631,172,308,172,76,326,313,171,86,85,639
P47182,32570.38,113.092,9.2987,47900,0.725,79,136,82,39,151,137,83,48,35,288
Q04301,62639.50,111.458,8.9907,82740,0.844,171,264,201,81,351,211,82,49,33,562
P10566,34501.54,109.878,8.3590,53860,0.837,116,168,94,43,177,137,51,32,19,314
P54838,62206.70,106.518,5.0500,27390,0.664,197,327,186,49,316,268,144,69,75,584
P36126,195204.00,115.986,7.5933,233540,0.768,386,747,407,211,742,941,532,295,237,1683
P39953,36960.77,110.331,10.1489,30830,0.804,110,172,105,43,189,146,58,40,18,335
Q05979,51032.09,112.654,4.9411,66810,0.496,117,221,131,62,255,198,112,53,59,453
P16862,104617.66,109.090,6.6365,105660,0.708,321,524,300,89,517,442,231,121,110,959
Q08438,73649.20,109.272,4.2618,40450,,203,407,145,41,271,403,211,84,127,674
P06197,24823.67,112.835,8.8015,41370,0.786,72,111,67,36,126,94,39,25,14,220
P40319,39465.35,114.392,9.6217,79760,0.759,98,150,120,68,214,131,55,39,16,345
P00175,65539.40,110.896,8.5649,61310,0.773,157,300,184,49,314,277,165,90,75,591
Q06137,58385.75,114.707,6.3963,47790,0.558,118,230,146,59,252,257,146,76,70,509
P25045,62207.14,111.482,6.0963,52260,0.639,159,282,168,63,297,261,117,60,57,558
P38929,130861.07,111.561,7.3589,97750,0.747,323,592,359,110,606,567,287,150,137,1173
Q06408,71384.41,112.416,6.5009,76210,0.728,167,317,181,79,339,296,147,77,70,635
Q12412,60250.84,111.783,8.3157,105200,0.838,168,277,172,94,349,190,78,47,31,539
Q01976,26086.99,112.931,6.2724,18450,0.586,55,108,64,18,116,115,71,36,35,231
P19516,34044.14,113.480,8.8023,27390,0.695,82,144,94,37,164,136,83,46,37,300
P28239,35572.60,114.750,7.4453,49390,0.766,67,143,80,37,152,158,88,48,40,310
P41940,39565.91,109.601,6.2577,31400,0.697,91,190,121,31,207,154,90,46,44,361
P25360,102539.76,111.094,6.2240,98780,0.680,268,444,294,101,510,413,202,103,99,923
P08566,174755.08,110.047,6.2182,160550,0.623,473,825,496,161,855,733,394,203,191,1588
P28321,35562.60,113.619,8.4250,38850,0.824,79,146,71,49,168,145,83,49,34,313
P08067,23364.95,108.674,8.0429,23950,0.838,70,119,64,21,123,92,51,29,22,215
P30902,19809.61,113.848,9.5384,16960,0.716,43,81,49,13,73,101,57,31,26,174
Q06510,44187.61,115.978,9.0594,72880,0.822,87,175,96,51,198,183,110,60,50,381
P36107,45193.36,112.702,6.0097,87780,0.683,119,206,125,77,258,143,58,30,28,401
P53283,67588.50,110.079,6.9580,111730,0.759,201,318,202,79,387,227,101,53,48,614
P24521,50454.89,111.873,6.4505,58330,0.590,130,232,128,57,229,222,129,68,61,451
P53685,57702.04,114.716,8.6308,40340,0.754,109,226,143,60,259,244,138,80,58,503
P38635,38581.83,115.170,5.8056,40340,,71,155,93,51,172,163,92,47,45,335
P38137,60488.65,111.397,9.6470,37820,0.892,149,290,154,67,295,248,123,74,49,543
P22219,166372.12,114.424,6.7479,140960,0.713,351,676,432,171,732,722,341,179,162,1454
P30402,24810.59,109.298,8.6289,11920,0.791,72,111,78,22,128,99,49,27,22,227
P04039,8906.66,114.188,11.0531,4470,,22,35,21,13,47,31,17,15,2,78
P07275,64435.20,112.061,6.9598,76210,0.747,160,290,160,78,315,260,137,72,65,575
P16622,44596.10,113.476,9.4466,56840,0.831,106,184,105,49,202,191,97,56,41,393
P50094,56393.87,107.622,8.2045,26360,0.848,175,282,154,41,287,237,113,62,51,524
P09440,106217.41,108.941,8.9967,53750,0.794,283,507,324,83,534,441,256,146,110,975
P38152,32173.31,107.603,10.0798,21890,0.829,110,163,95,28,171,128,62,39,23,299
P19955,13688.96,111.292,10.0732,9970,0.889,34,62,36,15,69,54,31,21,10,123
P49017,34684.53,112.979,6.4996,32890,0.686,83,147,80,38,158,149,85,44,41,307
Q04178,25190.73,113.985,5.3966,28420,,50,101,66,25,113,108,67,33,34,221
P16120,57474.25,111.818,5.3020,48820,0.590,142,253,154,58,262,252,133,65,68,514
Q06494,38600.78,111.886,5.8503,38390,0.616,96,169,99,42,179,166,93,47,46,345
P04806,53738.41,110.801,5.0999,45840,0.498,131,238,141,46,262,223,137,66,71,485
P39713,46098.58,110.548,6.0241,45380,,125,211,126,47,234,183,122,63,59,417
P46367,56723.66,109.294,6.6989,54320,0.749,160,273,161,54,286,233,123,64,59,519
P40363,33934.21,113.492,6.6839,55810,0.673,79,147,74,55,165,134,78,43,35,299
P40580,28804.15,109.521,6.2611,22920,0.692,75,135,88,21,149,114,63,32,31,263
P32452,38225.23,114.447,6.1216,41370,0.549,86,161,93,42,163,171,85,44,41,334
P38067,54189.25,109.033,6.5989,47330,0.727,160,268,153,52,283,214,114,59,55,497
P36150,66125.24,111.510,6.5135,47900,0.688,150,287,180,53,317,276,157,81,76,593
P46969,25967.10,109.105,6.2221,12490,,67,128,75,25,138,100,65,34,31,238
P10614,60720.22,114.566,8.9089,81710,0.741,128,236,150,81,299,231,136,80,56,530
P21306,6742.58,108.751,10.1879,11460,0.679,27,35,20,6,31,31,10,7,3,62
Q04174,59882.61,116.052,9.2905,94770,0.800,113,213,167,89,309,207,90,58,32,516
P07143,34054.56,110.209,8.1267,53860,0.809,104,168,87,40,173,136,76,43,33,309
P13181,63625.92,110.847,7.2238,114250,0.781,183,288,175,84,360,214,97,52,45,574
Q02196,23060.43,114.161,8.1215,21430,0.627,54,87,62,20,100,102,66,36,30,202
P29509,34238.07,107.329,5.7379,24410,0.591,116,171,99,27,176,143,78,39,39,319
P52892,56769.80,111.972,5.5320,43320,0.547,138,239,146,53,269,238,131,65,66,507
P13587,120357.33,110.318,5.2385,125250,0.582,329,583,336,116,588,503,254,124,130,1091
P0CW41,68698.66,116.636,5.2795,150230,0.598,146,275,122,97,283,306,180,88,92,589
Q12482,104304.32,115.637,8.0697,79080,0.752,200,400,238,130,437,465,245,133,112,902
P51601,27769.05,114.276,7.1617,15930,0.531,60,103,71,23,124,119,73,40,33,243
Q12084,26595.04,114.634,4.5682,21890,,47,107,71,21,112,120,68,30,38,232
P53909,39635.04,114.222,5.0649,39880,,82,157,98,49,179,168,106,51,55,347
P32567,95030.93,110.245,4.5972,51340,0.649,261,484,198,65,362,500,252,112,140,862
P14020,30362.25,113.716,7.8195,30370,0.691,65,120,82,38,157,110,63,35,28,267
P52290,53076.43,113.411,5.1917,81710,0.695,142,239,119,71,242,226,105,51,54,468
Q04894,39617.52,110.049,6.7070,47330,0.734,105,185,99,43,208,152,97,52,45,360
P05375,23150.26,112.380,9.2299,32890,0.840,60,94,64,28,128,78,37,23,14,206
P38858,27784.49,111.584,5.1692,30940,0.538,71,129,71,28,126,123,66,32,34,249
Q12358,46982.70,114.036,6.6374,51340,0.630,98,198,108,60,201,211,123,67,56,412
Q12165,17020.41,106.378,6.4734,2980,0.797,55,86,59,11,86,74,33,17,16,160
P39522,62861.05,107.455,7.8209,46300,0.864,200,313,165,51,331,254,136,75,61,585
P43123,53476.02,112.109,7.3757,52830,0.766,125,224,130,51,244,233,136,72,64,477
P32486,80122.85,111.282,4.2708,138090,0.582,231,409,158,103,366,354,153,61,92,720
P19262,50430.69,108.922,9.4204,17420,0.801,149,248,137,28,228,235,129,69,60,463
P40351,67385.05,116.785,9.8918,125710,0.668,129,234,202,114,369,208,104,69,35,577
P35842,52757.80,112.972,4.7798,80220,0.519,143,251,115,70,235,232,108,50,58,467
P26725,50836.08,118.776,4.9187,98670,,97,187,94,82,222,206,125,59,66,428
P00560,44738.43,107.544,7.5490,21430,0.708,125,220,145,36,232,184,118,63,55,416
P48239,41300.58,116.013,9.1635,54320,0.783,73,153,102,53,190,166,103,59,44,356
Q03557,50918.58,109.738,8.7837,25330,0.922,135,242,135,46,251,213,113,63,50,464
P54113,65282.43,110.461,6.5087,55810,0.639,164,309,192,61,321,270,152,79,73,591
Q05788,33754.88,108.537,7.2231,21430,0.823,95,167,96,29,179,132,69,39,30,311
P41277,27946.91,111.788,5.2228,40910,,64,123,78,33,142,108,78,38,40,250
P53257,35136.82,111.901,10.4258,48360,0.779,105,145,94,43,177,137,64,44,20,314
P47096,20234.98,114.322,5.5876,25440,0.557,38,88,42,22,92,85,50,25,25,177
P15202,58555.48,113.700,7.4101,78270,0.791,133,266,121,78,262,253,124,70,54,515
P15703,34118.60,109.005,4.1007,67380,,119,190,85,41,160,153,61,22,39,313
P53388,68097.45,112.002,9.1564,99130,0.844,178,298,198,96,383,225,114,66,48,608
P21264,62339.30,109.176,7.2982,29340,0.725,163,296,197,46,322,249,137,75,62,571
P27680,36330.88,116.445,6.9362,50420,0.542,69,134,83,38,158,154,89,48,41,312
P47177,45158.97,111.780,8.3072,21890,0.756,109,195,118,44,216,188,97,53,44,404
P16550,36492.55,113.684,4.6622,27390,,78,149,78,38,161,160,87,39,48,321
P00899,56767.57,111.968,5.6482,43780,0.548,135,252,150,51,264,243,134,67,67,507
P36013,74375.95,111.175,8.2242,57300,0.742,193,342,204,64,354,315,175,98,77,669
P07702,155345.60,111.599,5.7520,174990,0.652,376,728,415,156,744,648,345,173,172,1392
P09436,122983.51,114.723,5.8952,191030,0.510,251,504,306,142,557,515,316,159,157,1072
P38626,31493.83,110.894,9.1416,18910,0.795,69,142,89,29,163,121,72,42,30,284
P47051,47003.41,114.923,7.3804,62800,0.777,100,188,102,55,202,207,109,58,51,409
Q3E731,11105.47,113.321,5.0961,11460,0.609,26,50,18,9,48,50,29,14,15,98
P15625,57511.43,114.337,5.5300,55350,,117,222,136,59,246,257,145,72,73,503
P37254,88544.14,112.508,5.5496,102220,0.610,207,384,214,90,412,375,193,96,97,787
P40510,51188.27,109.143,6.3719,37360,0.719,145,246,155,43,246,223,105,55,50,469
P40011,25563.29,109.245,7.2869,14900,0.818,65,131,76,21,131,103,46,25,21,234
P23797,35445.96,116.599,9.1955,52830,0.747,63,134,97,49,164,140,71,43,28,304
P12683,115625.59,109.702,8.0362,93170,0.763,330,554,360,106,589,465,227,125,102,1054
P38925,63263.78,110.024,6.5591,59820,0.622,175,295,214,63,346,229,110,58,52,575
P25576,29673.40,115.013,7.9841,18910,0.702,56,110,75,35,136,122,70,40,30,258
P25373,12380.19,112.547,4.7197,5960,,24,48,38,9,58,52,31,14,17,110
P32318,34990.94,107.334,6.2197,26930,0.566,112,186,105,35,185,141,74,39,35,326
P28789,36674.57,112.155,6.3097,20400,,83,145,97,26,173,154,103,53,50,327
P32642,27492.90,112.676,4.2892,16960,,62,114,70,25,119,125,69,27,42,244
P39105,71667.41,107.933,4.3006,99810,0.742,241,407,187,73,348,316,116,47,69,664
P08417,53151.84,108.918,8.3101,21430,0.825,151,249,150,46,258,230,111,65,46,488
P40074,48840.34,109.019,8.8801,38850,0.815,138,217,189,49,298,150,61,40,21,448
P39002,77946.54,112.315,9.4043,100730,0.820,184,329,212,82,385,309,189,111,78,694
P38998,41464.83,111.166,9.5442,40910,0.794,104,192,121,42,209,164,99,59,40,373
Q05016,29158.41,109.208,6.7342,8940,0.557,79,136,97,19,142,125,68,35,33,267
Q12043,84715.88,113.105,9.5384,72310,0.923,205,360,196,90,363,386,161,98,63,749
P36076,65238.26,114.253,4.6425,39420,,128,268,133,44,224,347,186,83,103,571
P18239,34426.19,108.258,10.3270,35870,0.741,111,165,102,36,197,121,64,42,22,318
P53314,26731.58,111.848,7.4009,36440,0.734,65,128,73,28,128,111,56,32,24,239
P38342,35972.52,112.414,6.2391,39880,0.500,91,149,101,38,182,138,78,40,38,320
P22289,7476.36,113.278,5.7199,13980,,21,36,17,13,35,31,18,9,9,66
P38744,14026.11,116.884,8.9386,31970,0.582,32,53,31,18,55,65,40,25,15,120
Q99190,36767.87,118.606,9.9561,77810,0.717,67,125,87,71,182,128,68,46,22,310
P29029,59014.85,105.009,4.1434,62800,0.672,277,360,151,53,263,299,76,28,48,562
P53615,24859.21,112.485,6.9813,22920,0.682,64,112,61,26,106,115,50,29,21,221
P07258,45361.56,110.369,7.2531,43320,0.775,124,218,121,51,225,186,87,49,38,411
P32332,35153.02,108.497,10.0676,27390,0.863,101,162,110,32,192,132,60,39,21,324
P39676,44646.35,111.896,6.2315,42860,,103,187,133,46,218,181,107,56,51,399
P37298,20248.57,111.871,9.1777,31400,0.875,56,91,49,25,107,74,37,22,15,181
P21954,48190.38,112.594,9.1450,47330,0.714,119,198,123,45,218,210,124,69,55,428
P06169,61495.39,109.228,6.1012,63830,0.600,174,298,185,59,317,246,121,62,59,563
P14772,176874.09,113.454,7.6656,200890,0.737,394,715,507,173,850,709,350,184,166,1559
P53262,29678.04,111.993,3.7162,32430,,76,138,79,33,130,135,66,17,49,265
P38009,65263.31,110.242,6.5105,65780,0.650,171,308,198,61,325,267,152,79,73,592
P32837,61873.01,108.359,6.6052,112760,0.741,200,297,205,75,375,196,85,44,41,571
Q06817,71018.45,114.917,7.4844,52370,0.689,144,274,158,71,304,314,177,95,82,618
P38130,47482.38,117.531,8.9714,88810,0.820,94,179,88,78,210,194,118,70,48,404
P36007,34899.00,107.052,7.1067,13410,0.740,106,172,111,28,190,136,78,42,36,326
P30606,66710.15,109.540,8.3131,71850,0.815,205,309,192,76,355,254,109,62,47,609
P36165,102716.53,112.875,8.0799,76780,0.848,252,440,233,90,418,492,246,136,110,910
P53239,35650.17,112.817,11.7989,47440,0.656,90,147,108,30,176,140,48,38,10,316
P0C5R9,9360.97,110.129,7.7790,9970,0.734,26,48,33,14,57,28,14,9,5,85
P00937,53489.38,110.515,6.8890,40340,0.714,135,246,153,51,262,222,123,67,56,484
P50276,63221.31,110.142,7.6159,111730,0.790,175,290,201,87,372,202,84,45,39,574
P00830,54793.78,107.229,5.4104,21890,0.548,166,272,181,37,291,220,124,61,63,511
P47119,22093.03,112.147,5.3421,18450,0.499,53,94,56,26,103,94,53,26,27,197
Q3E7B6,8381.10,114.810,9.2757,17990,0.722,19,35,28,11,50,23,9,6,3,73
P36062,75459.45,109.045,8.6389,78270,0.918,230,369,219,86,393,299,123,74,49,692
Q99258,22567.65,108.498,5.5613,4470,,69,113,61,17,110,98,56,28,28,208
P17064,58201.25,109.196,4.8572,119750,0.674,183,279,188,84,356,177,73,34,39,533
P40086,54658.39,112.466,10.8265,97400,0.692,142,222,160,58,280,206,103,72,31,486
P07991,46086.01,108.693,6.9340,38390,0.641,133,215,145,52,246,178,103,59,44,424
P06208,68408.89,110.515,5.8422,68300,0.671,188,336,182,62,315,304,163,82,81,619
P38954,60873.32,115.509,7.8682,105310,0.753,130,241,153,108,311,216,102,61,41,527
P32288,41766.00,112.881,6.2853,69790,0.635,109,180,89,52,202,168,104,54,50,370
P39111,13461.21,114.078,4.6824,2980,,28,52,35,12,55,63,40,18,22,118
P39714,41581.96,108.853,6.5427,36440,0.612,113,200,115,42,217,165,103,56,47,382
P04801,84520.42,115.150,7.0045,107260,0.617,175,325,182,95,367,367,231,123,108,734
P32656,26293.56,113.334,6.1161,31860,,59,111,69,31,121,111,63,33,30,232
P0CX77,38686.58,106.869,4.4393,44810,0.702,131,207,113,37,209,153,64,27,37,362
P40345,75393.13,114.059,6.6582,123760,0.738,167,315,162,93,341,320,183,98,85,661
Q12372,64217.73,110.150,7.8993,93740,0.835,197,297,193,83,370,213,94,53,41,583
P53824,32033.04,107.493,5.2593,15470,,95,152,104,19,171,127,80,39,41,298
P54781,61334.39,114.004,7.9291,80790,0.606,134,254,167,75,304,234,136,76,60,538
P37303,42815.02,110.633,6.2306,41830,0.521,115,196,122,43,217,170,98,51,47,387
P40099,24058.73,114.022,7.0899,15930,0.507,51,91,60,28,112,99,64,37,27,211
P41903,40259.68,115.357,9.0590,50770,0.805,89,160,87,66,178,171,88,56,32,349
P32573,31108.97,106.538,9.4626,21430,0.834,102,161,104,28,173,119,68,40,28,292
P32796,77241.79,115.286,8.3191,103710,0.803,159,307,161,97,329,341,174,99,75,670
P38993,72360.07,113.774,4.3723,91220,,160,331,167,97,329,307,147,61,86,636
P08525,10974.54,116.750,10.0741,39420,0.894,24,41,19,21,58,36,18,13,5,94
P43635,53811.18,110.723,8.7293,50880,0.891,142,232,144,50,268,218,105,62,43,486
P53727,35366.80,111.567,6.7393,32890,0.616,87,153,104,34,172,145,74,39,35,317
P38174,47518.43,112.870,6.1634,37820,,107,205,108,46,202,219,140,72,68,421
P33734,61068.11,110.631,5.1469,59250,0.631,152,285,158,62,301,251,149,72,77,552
P32895,47047.47,110.181,5.4690,20400,0.506,120,220,134,33,221,206,123,61,62,427
P22580,61410.14,111.858,5.0686,76320,0.696,154,282,151,57,290,259,129,62,67,549
P38270,40453.61,117.598,9.6611,46870,0.736,57,140,102,39,180,164,93,59,34,344
P38714,73694.00,114.610,9.8416,79760,0.864,151,288,184,80,334,309,163,99,64,643
P47185,62920.41,110.971,7.9740,110240,0.807,178,281,179,87,366,201,96,53,43,567
P40825,110059.42,111.963,5.3863,96150,0.549,261,484,269,113,499,484,297,146,151,983
P33751,26733.31,110.468,10.2695,20970,0.781,79,123,81,25,135,107,57,37,20,242
P07236,54092.01,117.082,8.7331,77350,0.755,95,195,111,68,231,231,135,76,59,462
P16661,51929.04,115.655,9.0458,79760,0.747,94,185,144,65,260,189,110,65,45,449
P47082,65346.09,108.548,8.1313,45380,0.842,198,329,208,59,359,243,107,60,47,602
P39954,49125.51,109.411,6.1916,39880,,136,227,153,49,259,190,115,60,55,449
Q07648,16745.50,111.637,7.2784,8480,0.643,38,65,47,11,73,77,47,25,22,150
Q05998,66903.92,111.879,7.0403,161690,0.795,205,309,168,109,368,230,94,52,42,598
Q06508,33815.92,112.720,10.3165,24410,0.690,74,136,91,26,160,140,72,47,25,300
P06773,35646.08,114.250,7.8614,17420,0.668,83,146,87,31,156,156,88,50,38,312
P25346,57321.68,110.660,8.6308,87780,0.809,167,264,165,68,316,202,97,54,43,518
P32528,201832.11,109.990,5.2956,217850,0.698,541,966,554,182,1016,819,438,214,224,1835
Q07993,38600.42,108.428,6.0502,14900,0.613,107,188,114,36,205,151,90,46,44,356
P22803,11203.88,107.730,4.5408,11460,,35,60,37,10,62,42,23,10,13,104
P32891,65292.51,111.231,6.8056,60850,0.667,166,310,165,57,297,290,169,90,79,587
P07257,40478.15,109.995,7.9503,22350,0.714,107,195,127,36,194,174,96,50,46,368
P33336,86241.16,111.856,4.4472,144050,0.717,245,438,163,112,374,397,162,69,93,771
P38077,34350.52,110.452,9.8496,13410,0.854,94,156,99,21,153,158,79,46,33,311
P00912,24144.50,107.788,5.0765,22460,0.772,66,126,72,18,125,99,52,25,27,224
Q02783,47082.91,114.002,9.0837,23380,0.725,96,174,134,35,208,205,115,64,51,413
P00815,87721.24,109.789,4.9365,49280,,218,404,263,65,427,372,212,100,112,799
Q08986,64353.71,109.632,7.7994,87780,0.810,199,299,201,79,365,222,97,53,44,587
P38196,72165.16,112.935,7.4648,163640,0.744,193,321,204,104,387,252,114,60,54,639
P17898,44829.48,114.070,6.5579,72770,0.539,111,179,126,78,255,138,54,30,24,393
P48570,47098.90,110.044,7.2251,23380,0.632,121,229,144,40,227,201,122,66,56,428
P38971,64013.57,111.717,7.8569,117800,0.767,171,275,195,84,363,210,97,51,46,573
Q12271,124577.02,112.536,7.1701,117580,0.788,315,549,289,129,535,572,284,151,133,1107
P41939,46562.28,113.015,6.0786,52830,,110,193,121,47,214,198,122,62,60,412
Q12691,120296.18,110.262,5.1940,125250,0.595,331,585,338,113,585,506,255,124,131,1091
P40544,37418.31,108.145,7.0513,19940,0.718,118,176,123,50,203,143,60,38,22,346
Q12390,26339.59,113.045,8.8326,31400,0.709,59,104,71,26,132,101,65,37,28,233
P19097,206946.94,109.670,5.1072,187940,0.539,577,954,581,173,997,890,497,239,258,1887
P32048,66128.26,114.806,9.2104,51800,0.836,131,253,158,63,288,288,153,87,66,576
Q06636,25261.99,115.352,9.7152,59360,0.686,52,105,75,40,142,77,36,25,11,219
P43550,62134.60,105.135,5.6685,49280,0.672,214,334,204,50,347,244,142,71,71,591
P16861,107970.26,109.392,6.3427,97290,0.644,319,522,305,96,514,473,261,135,126,987
Q03579,17206.69,114.711,6.6261,25900,0.623,38,72,38,23,83,67,41,22,19,150
P0CX09,56470.17,112.490,6.0684,68760,,127,251,152,57,284,218,135,69,66,502
Q07471,68366.38,112.260,6.3195,83770,0.687,164,302,180,74,338,271,127,66,61,609
Q99321,21572.45,114.747,8.1432,23950,0.697,46,87,45,18,85,103,70,39,31,188
P21373,59469.18,112.206,7.1337,43890,0.807,147,278,139,52,247,283,148,80,68,530
P38211,50758.77,117.226,9.8038,117230,0.774,107,178,141,91,271,162,63,44,19,433
P39988,35559.19,113.972,6.4894,36330,0.530,76,143,91,38,171,141,79,41,38,312
P38710,32823.20,111.265,4.9153,55350,0.602,90,160,77,36,158,137,72,34,38,295
P53746,82015.34,114.069,9.4796,125030,0.804,200,323,228,123,429,290,155,100,55,719
P38115,38883.56,113.034,5.8235,42860,0.516,82,160,106,40,184,160,97,49,48,344
Q08905,80589.24,113.346,7.0714,141990,0.614,201,336,227,124,442,269,143,79,64,711
P21672,97514.64,112.215,5.8533,121130,0.574,258,437,243,99,451,418,216,109,107,869
P50113,30683.21,112.806,4.4240,26930,,76,131,77,35,150,122,60,25,35,272
P53184,24993.31,115.710,6.2201,42400,,46,106,59,32,104,112,70,37,33,216
Q04120,21614.88,110.280,7.1357,23950,0.719,52,103,65,21,112,84,50,26,24,196
P53686,39979.32,111.987,5.5970,29910,,93,176,97,43,181,176,106,53,53,357
P0CD90,17024.20,114.256,4.6662,41480,,46,79,33,29,85,64,31,14,17,149
P38230,37018.67,110.834,9.0624,38280,0.796,94,160,107,38,189,145,83,45,38,334
Q05584,31326.52,114.330,6.1035,35410,0.499,69,134,64,30,130,144,90,46,44,274
P40106,27813.77,111.255,6.0402,40910,0.515,67,126,78,33,144,106,73,37,36,250
Q06328,35179.01,110.975,4.6388,41830,0.657,104,155,97,40,180,137,54,24,30,317
Q12036,19973.16,115.452,8.4696,18910,0.753,43,75,47,27,93,80,49,30,19,173
P25580,47923.33,115.200,5.3603,51340,0.524,98,194,105,51,201,215,122,60,62,416
Q07950,62446.53,116.072,8.6528,106800,0.760,111,245,147,78,279,259,150,84,66,538
P40360,65610.16,114.303,9.2445,57300,0.835,135,264,163,74,280,294,163,96,67,574
P32451,41884.14,111.691,8.6047,43890,0.705,125,182,100,33,184,191,105,61,44,375
Q12154,39353.70,111.169,4.6088,19940,,98,173,95,32,178,176,90,40,50,354
P38857,14554.83,112.828,10.9511,31970,0.721,45,63,37,17,70,59,25,18,7,129
P20049,50923.33,112.662,6.5615,73800,0.620,125,211,137,61,240,212,111,59,52,452
P00331,36731.90,105.551,6.7094,46870,0.774,125,200,116,37,212,136,79,43,36,348
P32353,42730.30,117.069,7.6574,84800,0.649,79,163,108,74,208,157,86,52,34,365
Q12455,34090.76,113.636,4.7659,32890,,71,144,84,40,159,141,76,35,41,300
P38988,33215.49,110.718,10.6602,28420,0.806,90,143,90,38,169,131,68,46,22,300
P28240,62408.75,112.044,6.3679,82850,,163,273,159,67,290,267,159,83,76,557
Q06497,36367.35,110.876,10.3267,32890,0.795,102,158,109,39,181,147,60,40,20,328
P23900,73877.38,110.430,6.8828,92250,0.883,218,381,160,85,338,331,139,76,63,669
P07172,42646.12,110.769,6.3506,32320,0.649,109,200,124,34,211,174,92,47,45,385
P10127,41142.07,107.702,6.0837,19370,0.521,122,204,133,36,217,165,91,47,44,382
P22543,100921.40,115.339,7.8101,106690,0.743,181,389,258,97,444,431,234,126,108,875
Q02046,36239.62,113.249,6.9370,29340,0.675,73,155,98,33,168,152,86,45,41,320
P33317,15307.31,104.131,7.0109,5960,0.765,57,91,50,9,82,65,31,16,15,147
Q04299,32067.24,112.913,7.4623,37360,0.769,72,130,82,41,169,115,66,39,27,284
Q04935,23757.98,115.893,10.1031,59470,0.851,55,87,44,25,93,112,53,32,21,205
P40015,53940.50,113.083,7.5009,81820,0.646,143,227,146,65,255,222,120,68,52,477
P25594,50225.40,109.662,9.5102,45380,0.866,141,222,163,62,296,162,67,42,25,458
P38921,31026.85,109.249,10.0901,43890,0.869,107,146,83,34,164,120,50,33,17,284
P00044,12181.98,111.761,9.9565,12950,0.695,34,52,22,14,54,55,34,23,11,109
P25377,39348.46,108.999,7.2883,40910,0.800,107,183,109,41,210,151,95,54,41,361
P31755,55155.61,114.908,7.6269,87320,0.827,111,232,120,62,231,249,123,67,56,480
P38818,68284.38,116.725,4.6226,61770,,131,257,153,85,285,300,166,74,92,585
P00942,26795.46,108.046,5.8010,25440,0.643,77,137,85,23,137,111,64,32,32,248
P39965,65880.23,114.375,7.3808,81820,0.739,142,265,145,64,283,293,169,91,78,576
P36029,69242.73,112.043,5.0160,80790,0.531,163,298,218,87,375,243,113,54,59,618
P04397,78195.27,111.867,5.7991,91110,0.671,195,364,195,89,374,325,169,85,84,699
P50107,37208.90,114.138,6.8137,42860,0.761,84,154,68,50,160,166,97,53,44,326
P32842,17037.43,103.887,7.6037,10430,0.853,62,88,68,18,125,39,15,9,6,164
P07284,53309.58,115.389,5.9319,64290,0.529,100,194,119,56,225,237,151,76,75,462
P00927,63831.18,110.818,8.7126,35300,0.777,157,292,185,62,312,264,145,84,61,576
P13045,58129.07,111.787,6.9367,46300,0.681,155,271,150,66,276,244,128,69,59,520
P33303,35340.30,109.752,10.3137,24870,0.735,97,156,104,33,186,136,72,49,23,322
P07262,49569.95,109.185,5.3907,61310,0.754,149,238,129,47,249,205,104,51,53,454
P33401,63111.86,110.723,7.1996,74260,0.782,167,290,161,73,320,250,145,77,68,570
P09457,22814.40,107.615,10.2652,4470,0.870,64,113,77,14,111,101,54,33,21,212
P38145,26195.78,110.066,4.8046,14440,0.605,66,124,70,20,122,116,54,25,29,238
P40897,91615.55,114.663,8.9982,210050,0.827,207,389,241,143,496,303,134,80,54,799
P0CE00,67256.93,111.722,7.9761,123760,0.756,197,297,182,82,357,245,123,66,57,602
P39006,56594.79,113.190,9.5329,63370,0.886,135,243,131,66,262,238,124,73,51,500
P21826,62794.00,113.347,6.4541,72310,0.563,140,269,164,64,295,259,145,76,69,554
P32799,15021.13,116.443,8.1261,31970,0.677,29,62,33,23,67,62,42,25,17,129
P00427,17341.61,117.173,5.8465,11920,,32,65,45,19,73,75,50,25,25,148
P32347,41349.03,114.224,7.0156,58900,0.636,82,160,103,45,212,150,97,51,46,362
Q03028,34206.24,110.343,10.4483,32890,0.689,89,156,103,37,188,122,65,44,21,310
Q03529,44881.48,116.879,6.5378,85260,,88,167,104,83,220,164,105,58,47,384
P25613,30726.16,108.573,4.7880,48360,0.681,96,154,96,46,188,95,39,18,21,283
P41835,58058.71,107.516,5.7345,39880,0.717,181,303,173,40,302,238,114,57,57,540
Q12198,64223.33,111.693,6.9799,61310,0.790,161,291,161,67,308,267,149,77,72,575
P06738,103275.32,114.496,5.3083,147140,,207,421,259,115,467,435,249,122,127,902
Q06346,25483.89,115.312,8.0209,47900,0.677,58,93,72,36,130,91,38,22,16,221
P0CX78,38686.58,106.869,4.4393,44810,0.702,131,207,113,37,209,153,64,27,37,362
Q12362,67035.80,113.428,6.5045,68760,0.635,152,301,145,68,294,297,179,94,85,591
P39518,83437.96,112.148,7.7411,64750,0.736,205,366,221,85,399,345,191,103,88,744
P40550,160537.56,113.776,6.8527,206850,0.656,392,674,413,218,782,629,297,161,136,1411
P08432,52285.33,112.200,5.2244,46300,,131,237,137,61,247,219,121,59,62,466
Q12283,40707.30,113.076,6.8821,31860,0.809,93,181,101,37,175,185,78,42,36,360
P32563,95528.76,113.725,5.1570,134650,,225,379,259,124,474,366,200,97,103,840
P23337,80510.26,113.715,5.8989,90190,,172,349,208,94,373,335,199,101,98,708
Q12265,53504.76,107.873,7.2351,28880,0.845,170,281,150,39,254,242,104,57,47,496
P50942,133331.13,112.706,8.8727,109100,0.871,328,593,301,130,562,621,319,179,140,1183
P28496,48992.05,117.206,9.8118,89270,0.744,105,180,122,78,236,182,91,58,33,418
P32366,39790.67,115.335,4.2204,53290,,88,157,96,47,177,168,84,32,52,345
P38787,42821.28,112.985,6.5977,35870,0.661,96,183,113,39,202,177,92,48,44,379
P38359,95950.96,111.701,6.7652,144620,0.720,256,453,270,115,480,379,182,96,86,859
Q08992,25940.47,109.453,7.4649,25900,0.764,77,125,72,33,133,104,60,33,27,237
P47011,44546.02,117.226,5.9362,55350,,76,154,106,56,192,188,106,54,52,380
P53630,26256.86,110.788,4.7950,33460,,64,124,72,24,125,112,52,24,28,237
P53208,37936.88,115.661,8.7753,31860,0.830,68,140,95,46,174,154,84,50,34,328
P38063,35720.00,109.571,6.3393,10430,0.502,94,170,116,26,172,154,86,45,41,326
P49723,40054.61,116.100,4.8582,45840,,79,145,91,53,177,168,103,48,55,345
P38085,68757.56,111.078,7.7211,96260,0.784,188,311,205,88,372,247,117,66,51,619
P13259,49406.19,116.524,9.0851,32890,0.795,94,200,84,40,157,267,151,82,69,424
P38286,38708.16,111.551,10.0090,31400,0.789,103,158,115,34,188,159,77,48,29,347
Q08911,41714.31,110.942,6.4210,40340,0.581,101,192,119,36,198,178,108,56,52,376
P53157,14995.40,115.349,9.8852,24410,0.606,36,55,34,22,71,59,31,20,11,130
P32901,68043.59,113.217,5.0414,114710,0.581,169,287,175,101,368,233,115,55,60,601
P21182,46232.42,116.749,5.3191,61310,,96,175,92,65,189,207,114,56,58,396
Q01662,43373.31,112.076,7.8806,48820,0.793,116,204,90,45,194,193,107,62,45,387
P14540,39620.77,110.364,5.5914,38850,0.500,108,182,102,45,194,165,98,49,49,359
P43544,25131.93,113.207,7.3881,19940,0.578,54,105,72,28,119,103,59,33,26,222
P06785,35047.25,115.287,7.0853,38390,0.598,68,136,72,40,161,143,96,51,45,304
P37297,214607.05,112.951,7.4855,190810,0.685,529,883,589,236,995,905,449,246,203,1900
P81450,6687.79,113.352,10.2276,9970,0.749,15,31,16,10,37,22,14,9,5,59
P41948,53400.65,107.015,6.6372,118830,0.798,192,286,164,68,329,170,70,38,32,499
P18238,33312.88,108.511,10.3814,32890,0.724,108,156,95,35,185,122,62,41,21,307
P53315,28447.71,111.560,5.0103,29450,0.506,66,126,79,29,144,111,63,30,33,255
P53128,68560.16,114.267,5.5828,108750,0.578,139,282,167,78,321,279,148,74,74,600
Q01519,9787.90,117.927,5.0199,26470,,19,41,15,15,41,42,25,12,13,83
P07259,245040.76,110.678,5.6041,196200,0.589,626,1156,715,222,1199,1015,550,274,276,2214
Q05911,54510.47,113.092,6.3809,53400,,128,227,161,51,252,230,135,70,65,482
P39104,119923.19,112.498,6.4496,67730,0.702,294,520,290,98,481,585,296,153,143,1066
P25628,71613.08,117.398,8.3229,128230,0.616,154,267,166,117,343,267,133,77,56,610
P32643,34768.29,116.282,6.1747,59360,0.495,71,138,69,45,146,153,96,49,47,299
P50861,18555.52,109.796,6.4919,20970,0.514,47,83,58,17,100,69,45,24,21,169
P40495,40068.94,108.003,8.0152,14900,0.749,118,197,126,25,204,167,92,49,43,371
P32579,46538.47,109.245,7.1852,22920,0.789,125,226,140,33,228,198,108,58,50,426
P41909,100025.40,114.972,10.0020,100160,0.815,196,378,277,106,466,404,221,133,88,870
P38999,48917.84,109.681,4.8731,62800,0.512,136,240,144,45,251,195,115,54,61,446
Q06685,129755.20,113.224,8.9937,96720,0.839,282,547,293,110,538,608,347,193,154,1146
P43601,55102.13,110.204,5.2032,26820,0.727,164,269,132,48,243,257,115,56,59,500
P39003,62705.05,110.009,7.7273,108750,0.771,186,295,188,79,367,203,96,52,44,570
P32626,25187.44,110.958,5.2994,24870,0.603,60,117,70,28,123,104,53,26,27,227
P32327,130166.68,110.311,6.4611,91680,0.585,331,603,380,113,645,535,314,164,150,1180
P25372,14432.10,113.639,9.1723,11460,0.691,31,59,37,12,72,55,32,19,13,127
P48525,61603.30,114.932,9.4692,57300,0.844,129,227,145,67,273,263,159,96,63,536
P61829,7759.44,102.098,7.9875,1490,0.842,29,40,37,7,60,16,5,3,2,76
P14065,35079.16,112.433,7.9680,50420,0.742,75,155,96,32,159,153,84,47,37,312
Q06405,11312.13,112.001,10.6630,14440,0.553,29,48,31,19,60,41,26,21,5,101
P00447,25774.22,110.619,8.7153,44920,0.774,71,118,70,31,127,106,52,30,22,233
P40416,77522.25,112.351,10.1825,67840,0.797,184,324,233,72,377,313,162,98,64,690
P38720,53543.25,109.495,6.5874,66350,0.713,150,251,153,54,284,205,121,63,58,489
P47169,161219.09,111.802,5.1475,158490,0.593,389,719,416,157,723,719,376,182,194,1442
P38125,63406.86,110.851,9.0098,84800,0.868,175,281,184,83,353,219,101,61,40,572
P47088,47166.34,117.038,9.3163,116200,0.781,96,168,131,83,258,145,63,41,22,403
Q04430,40903.17,111.453,6.3389,43320,0.806,114,177,91,52,191,176,76,40,36,367
P15624,67364.98,113.218,5.5456,47330,,142,283,174,65,304,291,173,86,87,595
P80235,77765.53,113.196,6.9013,95230,0.635,205,353,191,89,344,343,168,91,77,687
P38221,51822.94,113.398,8.6933,49850,0.735,128,208,147,77,271,186,89,55,34,457
P39986,135268.56,111.332,6.5528,118150,0.642,335,586,393,137,688,527,283,147,136,1215
P38627,64510.57,111.610,5.3908,63830,0.497,151,281,170,59,307,271,160,79,81,578
P53688,41765.29,112.879,9.5572,14900,0.891,90,183,100,36,189,181,102,63,39,370
P00958,85678.09,114.085,6.5809,123650,0.665,180,359,209,102,380,371,204,108,96,751
P47176,41624.72,110.704,7.2199,63370,0.764,116,191,104,39,210,166,86,45,41,376
P28817,56288.39,112.577,8.4279,47330,0.798,145,251,135,53,251,249,115,63,52,500
P36033,80072.23,112.619,9.3875,124570,0.829,210,345,228,114,430,281,145,93,52,711
P47190,86322.73,114.638,6.8878,194120,0.666,196,353,225,134,455,298,160,88,72,753
Q08914,25926.44,109.394,7.4649,25900,0.764,77,126,72,33,133,104,60,33,27,237
P25568,58843.75,111.446,8.5186,98320,0.821,155,260,184,77,324,204,82,46,36,528
Q12205,96997.34,114.249,5.3654,91220,0.683,206,393,216,92,406,443,224,110,114,849
Q05789,25975.44,114.936,5.2612,18450,0.709,44,94,62,11,94,132,68,33,35,226
P06780,23152.45,110.777,5.9926,21430,0.624,59,109,62,16,111,98,54,27,27,209
P37292,53686.39,109.564,9.0139,44810,0.867,154,247,141,54,267,223,118,69,49,490
P17709,55377.42,110.755,6.1226,30370,0.517,145,245,148,49,263,237,134,69,65,500
P32363,51242.22,113.368,7.2250,52370,0.592,116,219,142,59,242,210,113,64,49,452
P47912,77267.12,111.336,6.5087,97750,0.613,190,339,214,76,391,303,183,95,88,694
P54070,52128.07,116.879,5.1564,92820,0.503,98,195,104,73,230,216,126,61,65,446
Q08548,72228.02,116.685,9.9402,123190,0.746,156,254,156,109,344,275,159,101,58,619
P38986,41395.20,108.649,5.0792,25330,0.697,116,209,117,35,211,170,81,39,42,381
Q12680,238101.81,111.003,6.5457,232860,0.667,605,1084,642,210,1139,1006,579,302,277,2145
P40054,51193.22,109.154,5.2776,37360,0.637,143,247,156,41,247,222,96,47,49,469
P46655,80842.75,114.185,7.5157,100270,0.556,159,339,210,77,362,346,230,122,108,708
P40350,38346.82,114.811,8.9814,35870,0.658,80,137,111,43,186,148,92,53,39,334
P32487,68089.71,111.440,6.9517,128230,0.714,181,305,212,92,381,230,105,56,49,611
Q02891,51723.62,113.429,7.5759,76320,0.748,128,227,119,69,236,220,118,67,51,456
P06106,48671.72,109.621,6.4033,51800,0.689,135,233,131,66,248,196,103,55,48,444
Q12359,30028.46,109.194,4.3560,43890,0.725,99,151,80,40,173,102,34,14,20,275
Q04895,71756.22,113.002,7.8354,164210,0.766,186,320,209,114,410,225,101,56,45,635
P05374,101203.58,116.460,8.4740,195500,0.737,206,384,250,150,476,393,184,104,80,869
P32264,47162.11,110.192,6.7261,31400,0.625,115,218,141,34,225,203,115,61,54,428
P37012,63088.54,110.876,6.5795,78730,0.745,168,291,153,74,309,260,148,77,71,569
P39924,62734.20,111.231,7.1973,108750,0.754,172,275,180,84,363,201,102,54,48,564
P07246,40369.51,107.652,8.5413,45380,0.838,122,204,122,38,218,157,90,52,38,375
P33327,124332.13,113.857,5.4548,102570,0.618,252,513,311,139,547,545,285,141,144,1092
P38066,38331.95,111.107,6.2825,31400,0.646,103,177,92,30,168,177,100,52,48,345
P52893,66421.62,112.199,6.9945,53290,0.727,164,277,168,68,302,290,146,80,66,592
P13586,104570.78,110.075,5.3641,39880,0.621,270,490,309,72,503,447,226,111,115,950
P0CW40,68698.66,116.636,5.2795,150230,0.598,146,275,122,97,283,306,180,88,92,589
P26637,124141.56,113.891,5.6020,148980,,283,491,301,144,577,513,324,161,163,1090
P38816,37087.35,108.443,6.8361,24410,0.716,117,182,107,32,188,154,81,43,38,342
P40025,37718.94,117.504,5.0532,44350,,57,126,86,43,154,167,98,47,51,321
Q12211,62142.55,114.233,8.2596,53290,0.713,129,243,134,60,261,283,186,99,87,544
P25379,39301.36,109.170,8.9636,25900,0.873,110,190,114,33,198,162,80,47,33,360
P53598,35032.45,106.482,8.6366,8940,0.791,113,170,104,27,189,140,73,41,32,329
P36421,44019.96,111.726,8.6544,24870,0.766,94,185,119,39,215,179,105,57,48,394
P16387,46343.03,110.341,8.1296,47790,0.750,138,211,116,48,237,183,107,59,48,420
P53178,22661.05,112.183,5.6598,14440,0.581,55,94,59,23,111,91,46,23,23,202
P38715,37118.78,113.513,7.0451,45380,0.605,79,146,97,44,177,150,91,50,41,327
P21595,56071.22,114.665,8.9887,69330,0.757,112,217,153,67,278,211,119,68,51,489
P53099,64546.35,111.479,8.7964,136250,0.845,188,292,190,92,365,214,97,59,38,579
Q10740,77352.84,115.280,6.5470,105770,0.589,164,311,177,104,337,334,181,96,85,671
P27616,34603.45,113.083,5.7349,45380,,78,142,91,34,155,151,94,47,47,306
P18408,30380.32,116.400,5.7915,48360,,59,106,69,40,127,134,79,40,39,261
P33333,33886.92,111.838,10.1466,32890,0.726,80,146,96,34,173,130,70,47,23,303
P35731,31183.98,112.173,9.1178,43890,0.885,89,134,78,26,147,131,61,36,25,278
Q04066,29991.33,114.909,4.9772,31860,,61,119,77,31,136,125,61,29,32,261
P00128,14564.79,114.683,5.6905,14440,,27,52,45,13,69,58,38,19,19,127
P08524,40483.43,115.010,5.1079,51800,,83,149,108,45,186,166,106,51,55,352
P38992,40734.26,116.717,8.5921,58330,0.530,78,139,102,72,203,146,88,54,34,349
P32771,41042.05,106.327,6.7338,22920,0.600,142,220,119,35,221,165,100,53,47,386
P32377,44115.91,111.404,5.4865,53400,0.546,129,205,113,44,198,198,97,48,49,396
Q12471,45317.63,114.150,5.4020,22350,0.678,107,198,94,59,180,217,97,48,49,397
P40459,35032.24,113.373,5.0815,24410,,71,153,98,31,164,145,77,37,40,309
Q12056,16929.74,108.524,10.1500,5960,0.774,49,83,51,14,85,71,41,28,13,156
Q12068,38169.50,111.607,6.0575,25440,0.542,89,173,102,40,175,167,100,51,49,342
P00635,52858.55,113.187,4.4090,84690,,143,255,114,74,237,230,109,46,63,467
P32368,71124.64,114.165,7.6793,88240,0.688,152,303,179,95,324,299,160,90,70,623
P32356,85879.23,114.353,7.7692,128580,0.730,202,356,188,106,391,360,203,110,93,751
Q12189,28258.10,109.528,5.7109,15930,0.616,69,133,85,24,139,119,74,37,37,258
P08004,129870.74,114.828,6.1502,169380,0.737,291,547,284,164,574,557,256,131,125,1131
P50277,53708.69,111.893,6.4070,63830,0.602,126,238,140,61,264,216,114,61,53,480
P53206,42800.87,108.908,8.2831,41370,0.815,126,210,129,38,214,179,98,56,42,393
P33312,27116.18,111.132,6.7452,33460,0.734,66,129,72,22,130,114,56,30,26,244
P22140,44559.79,113.964,6.4892,76780,0.621,109,181,125,73,241,150,61,33,28,391
P07149,228691.28,111.502,5.7335,218880,0.628,555,1038,605,236,1102,949,501,251,250,2051
P40886,63492.52,111.586,5.2170,100730,0.667,184,293,166,85,353,216,101,49,52,569
P35196,32693.63,114.313,7.7296,30940,0.641,76,125,82,31,144,142,92,50,42,286
P35497,38165.64,106.907,6.8932,20860,0.730,114,209,114,39,213,144,86,46,40,357
P38131,54555.99,117.578,4.4673,97180,,99,211,106,76,229,235,134,57,77,464
P53167,41891.27,113.220,8.7926,48360,0.838,102,174,107,45,208,162,90,55,35,370
P38734,60619.68,111.025,8.9122,84800,0.838,161,267,194,89,361,185,81,49,32,546
P00854,29099.04,112.352,8.0215,43890,0.713,69,108,108,42,183,76,21,13,8,259
P47143,36372.34,106.977,4.7710,25900,,112,192,117,36,197,143,78,36,42,340
P40004,39266.25,114.814,9.8054,45840,0.748,91,149,109,59,201,141,58,41,17,342
P53966,61727.88,118.253,5.4893,99240,,110,222,123,95,268,254,155,77,78,522
P25358,40002.16,115.280,9.8217,71280,0.706,84,155,119,68,221,126,60,44,16,347
Q00711,70229.37,109.733,7.4769,69790,0.695,218,340,183,73,337,303,173,99,74,640
Q05567,65565.61,111.317,8.0625,78730,0.795,167,293,175,77,336,253,138,80,58,589
P34230,97126.44,113.865,9.2405,74260,0.826,219,381,252,83,406,447,231,131,100,853
P06168,44368.46,112.325,9.4108,66810,0.822,118,196,109,47,212,183,105,59,46,395
Q03786,22174.68,114.895,7.1067,16960,,44,84,54,23,94,99,70,38,32,193
P37299,8592.94,111.597,8.5460,15470,0.910,24,37,19,12,45,32,16,10,6,77
Q08224,61269.35,111.197,6.0733,71740,0.517,158,279,169,62,306,245,141,72,69,551
P29704,51719.90,116.486,5.7439,50770,,86,177,143,62,242,202,121,61,60,444
Q00873,26076.14,116.411,7.0311,54430,0.768,53,110,43,30,101,123,69,37,32,224
P07277,48459.51,109.389,5.2812,29910,0.597,137,224,141,43,237,206,100,49,51,443
P20048,58906.20,113.499,9.1942,62340,0.786,129,216,195,68,318,201,84,51,33,519
P00330,36849.17,105.888,6.6481,48360,0.732,122,198,116,37,215,133,78,42,36,348
Q05506,69524.99,114.539,6.7476,85260,0.516,140,257,182,76,324,283,177,93,84,607
Q06549,15536.02,109.409,7.0916,9970,0.824,48,78,40,13,83,59,29,16,13,142
P40582,26794.80,114.508,6.6147,32890,0.610,53,98,71,35,129,105,66,35,31,234
P27809,51386.70,116.260,5.0692,107720,,112,204,106,76,225,217,123,59,64,442
Q08579,67185.50,112.163,7.1518,154700,0.776,203,306,172,109,371,228,94,52,42,599
P28241,39739.45,107.695,8.9400,18910,0.887,123,208,121,30,199,170,79,45,34,369
Q12289,34754.22,106.282,10.4548,21430,0.908,120,181,100,30,187,140,58,39,19,327
Q12251,35913.24,110.163,9.8724,55350,0.907,105,173,105,38,189,137,57,36,21,326
P32352,24895.61,112.142,5.7972,37360,,66,106,67,38,135,87,43,22,21,222
Q03161,33955.87,114.330,6.0435,61880,,70,134,83,39,154,143,78,40,38,297
P17505,35649.96,106.736,8.8055,4470,0.855,103,186,112,24,182,152,84,47,37,334
Q03764,61656.99,115.463,5.6379,95800,0.565,127,246,131,70,255,279,152,76,76,534
Q12333,70905.39,114.364,8.7564,111160,0.821,162,283,188,101,366,254,131,79,52,620
Q08220,55815.23,113.677,5.3151,59250,0.665,122,228,135,55,241,250,131,64,67,491
P40107,37018.69,109.848,9.6964,49390,0.901,111,174,124,45,213,124,39,26,13,337
P23585,59840.71,110.611,8.3615,90760,0.823,179,274,166,79,344,197,84,46,38,541
Q04121,70148.04,110.818,4.4250,72770,0.549,180,319,219,79,379,254,102,43,59,633
P09624,54010.05,108.237,8.0827,20400,0.727,149,256,165,42,270,229,140,78,62,499
P47147,80151.77,116.500,7.5789,105770,0.759,151,312,165,99,320,368,192,107,85,688
P29465,131601.23,112.962,6.6765,187590,0.709,321,599,314,143,603,562,290,152,138,1165
P33775,92675.44,113.434,6.6692,169600,0.630,227,390,244,137,474,343,177,96,81,817
P53687,50523.98,113.029,9.5863,43430,0.887,123,211,115,37,208,239,129,77,52,447
P0CD91,32712.79,107.255,6.9372,50420,0.667,119,173,107,39,193,112,51,29,22,305
Q03941,27339.76,113.443,8.7168,21890,0.761,57,109,77,21,129,112,63,35,28,241
P38628,62066.71,111.430,5.7426,49280,,164,285,170,66,293,264,143,72,71,557
P53045,36479.13,118.055,8.0976,95800,0.619,77,125,84,74,185,124,68,44,24,309
P27796,44730.35,107.267,7.5383,13410,0.820,129,224,143,27,239,178,95,50,45,417
P38013,19114.67,108.606,4.7820,30940,0.515,58,104,55,20,97,79,39,18,21,176
P16467,61912.07,109.968,6.3933,65320,0.586,165,293,188,60,319,244,126,66,60,563
P22007,48189.94,111.810,6.3374,66810,0.671,130,215,122,50,236,195,108,56,52,431
P47180,37286.84,103.288,8.2210,43430,0.976,159,238,98,27,185,176,57,33,24,361
P53341,68094.26,116.600,5.4421,148740,0.557,144,270,122,101,287,297,174,86,88,584
P38329,123998.59,110.713,8.6782,128690,0.837,336,571,351,125,634,486,205,117,88,1120
P49089,64470.27,112.710,6.0203,94770,,168,277,163,76,308,264,170,87,83,572
P10963,60983.21,111.081,6.3018,76780,0.665,170,288,152,67,294,255,132,69,63,549
P31381,58317.30,112.799,4.6883,66350,,143,249,163,72,294,223,104,47,57,517
P25578,59370.29,113.954,10.1532,75750,0.823,141,242,147,66,265,256,117,76,41,521
P17423,38712.43,108.438,5.0546,27390,0.742,109,195,114,27,209,148,71,34,37,357
P53943,65296.27,111.427,8.9635,86290,0.870,187,286,176,76,349,237,107,64,43,586
P32316,58711.92,111.620,6.7580,46870,0.669,133,269,155,60,280,246,147,80,67,526
P23542,46057.62,110.186,8.4302,53860,0.754,130,216,132,52,229,189,94,55,39,418
P06776,60999.75,115.969,6.5983,63370,,115,228,154,77,258,268,140,77,63,526
P09938,46147.44,115.658,4.9026,49390,,90,167,114,57,200,199,128,60,68,399
P11325,101920.31,114.005,8.5190,144730,0.775,213,426,241,108,470,424,238,131,107,894
P0CX08,56470.17,112.490,6.0684,68760,,127,251,152,57,284,218,135,69,66,502
P38812,20945.15,113.217,8.9723,28420,0.894,44,95,54,23,98,87,47,28,19,185
P48015,44469.03,111.173,9.2037,44350,0.821,110,196,118,47,216,184,101,59,42,400
Q04806,42402.95,115.855,7.4996,79300,0.675,90,175,96,57,189,177,107,59,48,366
Q08558,30057.89,110.915,8.7714,14440,0.851,74,131,87,33,147,124,57,34,23,271
Q06489,45020.37,109.539,4.6402,34380,0.563,119,223,134,34,219,192,96,43,53,411
Q06451,68065.76,109.430,7.0307,111730,0.819,206,328,204,80,390,232,104,55,49,622
Q12676,47851.15,112.064,6.8036,41370,0.668,111,206,134,42,229,198,101,55,46,427
P12709,61299.25,110.648,6.4189,73340,0.632,169,285,163,77,289,265,128,68,60,554
Q12349,14127.82,113.934,4.3356,15470,,28,58,36,9,58,66,38,15,23,124
P39730,112268.42,112.044,5.4469,59820,,255,450,289,56,447,555,362,178,184,1002
P38891,43596.06,110.931,9.2498,66350,0.849,117,199,113,43,221,172,89,51,38,393
A2P2R3,29272.26,111.726,6.1650,19370,0.593,72,130,75,33,136,126,69,36,33,262
P39533,86583.20,109.738,6.9269,80790,0.796,242,418,216,78,410,379,196,104,92,789
P40545,29556.63,113.244,5.6809,47440,,69,126,72,30,132,129,80,40,40,261
P43534,38591.71,113.505,7.9596,51800,0.658,89,153,95,42,192,148,92,50,42,340
O13525,38627.16,115.305,10.1280,44350,0.650,78,138,107,37,185,150,97,61,36,335
Q00955,250353.41,112.115,6.2051,233320,0.610,587,1074,674,237,1174,1059,608,312,296,2233
P03962,29239.51,109.511,7.2644,29910,0.600,85,136,84,24,148,119,76,40,36,267
P53223,27649.12,115.687,8.5580,42860,0.841,60,107,74,45,145,94,40,24,16,239
P38090,67261.97,112.856,7.1678,106690,0.699,169,287,193,95,367,229,116,63,53,596
P07256,50227.82,109.908,7.2364,50420,0.812,139,243,145,44,226,231,102,55,47,457
P38695,66251.47,111.911,7.5587,110700,0.801,190,302,163,85,358,234,102,53,49,592
P54861,84971.98,112.248,5.1551,38280,0.599,185,364,227,54,368,389,215,104,111,757
Q04585,79161.04,110.715,6.7504,70820,0.754,224,367,198,68,368,347,178,93,85,715
P38774,27099.88,110.162,4.9911,28420,,71,134,79,25,133,113,65,31,34,246
P08456,30804.55,111.611,6.2193,8940,0.568,80,137,81,41,162,114,61,32,29,276
P43545,32019.02,107.446,5.2593,15470,,95,153,104,19,171,127,80,39,41,298
P37296,101660.77,114.226,5.0376,127200,,221,395,266,122,491,399,213,102,111,890
P32603,51809.47,116.426,5.6097,115740,,105,200,117,73,230,215,120,60,60,445
P23254,73805.64,108.538,6.9783,88240,0.804,222,367,209,80,381,299,151,82,69,680
P14742,80046.74,111.641,6.3916,53290,0.564,194,343,226,73,380,337,195,102,93,717
P00360,35749.94,107.681,8.3918,34380,0.716,109,192,113,32,185,147,84,47,37,332
P00163,43655.91,113.392,8.8782,69790,0.815,95,179,142,77,271,114,44,31,13,385
P31373,42542.08,107.975,6.5049,25900,0.653,126,216,135,40,209,185,91,49,42,394
P40433,93417.06,112.959,8.9918,76210,0.899,213,430,201,82,377,450,232,128,104,827
P81451,7533.77,110.791,9.5695,2980,0.846,16,31,20,8,37,31,21,13,8,68
P40035,33528.33,111.761,9.7941,59820,0.760,95,144,84,42,182,118,54,37,17,300
P53753,121064.45,108.384,4.1329,162390,0.704,434,665,295,128,534,583,167,61,106,1117
P38705,50389.99,112.982,9.0271,44350,0.807,115,204,131,37,223,223,121,67,54,446
Q07786,38096.53,106.713,6.6876,20860,0.722,115,210,114,39,213,144,85,45,40,357
Q04013,34184.57,108.868,10.4895,50420,0.850,107,166,91,32,179,135,63,42,21,314
P80210,48279.39,111.500,8.2090,54320,0.750,112,213,128,49,238,195,121,66,55,433
P53051,68591.56,116.454,5.1295,151720,0.553,145,276,124,99,286,303,178,86,92,589
P18544,46681.44,110.358,7.5035,28880,0.680,125,207,131,45,223,200,116,64,52,423
P47075,83154.79,115.333,6.7899,92710,0.562,161,334,200,92,359,362,218,114,104,721
P15180,67958.55,114.989,6.0115,40800,,131,259,150,68,297,294,195,99,96,591
Q04792,65989.95,112.803,6.6030,74830,0.655,156,276,157,77,298,287,160,87,73,585
P38358,51677.12,109.023,10.1529,53860,0.914,163,229,172,56,296,178,55,39,16,474
P15365,60850.14,112.063,8.7058,100270,0.757,159,260,189,72,329,214,103,58,45,543
Q08975,61334.30,111.315,5.7723,70250,,158,280,175,60,304,247,141,71,70,551
P33421,22068.00,111.455,10.7834,35410,0.608,67,87,70,28,117,81,34,27,7,198
P38084,67769.43,111.280,8.2855,98210,0.802,192,299,195,95,373,236,110,63,47,609
P38287,44381.99,118.037,9.4413,89270,0.851,85,161,88,69,194,182,101,62,39,376
P53631,62828.31,111.398,6.9510,108750,0.739,170,273,177,84,363,201,103,54,49,564
Q01802,51795.42,114.846,9.2068,82280,0.895,104,212,120,64,242,209,102,61,41,451
Q12385,45140.72,114.570,9.5022,66810,0.862,100,192,105,58,201,193,98,61,37,394
P32465,63261.35,110.985,7.3703,109210,0.813,186,300,164,89,367,203,87,47,40,570
P41815,67365.02,111.531,8.1957,95230,0.808,182,301,191,91,369,235,113,64,49,604
P0CX79,38686.58,106.869,4.4393,44810,0.702,131,207,113,37,209,153,64,27,37,362
Q02895,39682.70,116.031,7.2706,48360,0.536,77,140,99,43,172,170,104,57,47,342
Q05533,32092.57,109.906,5.3984,47900,0.681,94,150,81,36,169,123,67,33,34,292
Q06144,24854.68,115.068,8.4121,37930,0.790,52,103,62,29,116,100,42,24,18,216
P25332,36924.05,110.883,4.9325,25900,,91,163,98,32,176,157,87,41,46,333
P31115,50888.76,115.133,9.7442,45840,0.778,103,207,120,50,218,224,128,77,51,442
P48360,56237.23,114.071,9.3470,75860,0.879,121,232,127,61,245,248,143,81,62,493
P28274,64710.28,111.762,5.9039,59820,,151,275,171,63,310,269,169,86,83,579
P32584,27887.68,116.685,7.9026,41370,0.621,54,91,78,51,145,94,52,32,20,239
P32378,41001.47,110.219,10.4689,88350,0.792,127,184,123,47,244,128,59,42,17,372
Q06667,32918.04,117.146,7.8372,60850,0.712,57,126,81,39,143,138,71,41,30,281
P32798,48154.87,109.692,6.2615,43890,0.545,138,225,143,58,237,202,97,53,44,439
P39007,81528.93,113.550,8.0167,170630,0.630,204,342,243,123,453,265,138,76,62,718
P11491,63004.11,111.315,5.3248,57300,,167,296,162,76,277,289,158,78,80,566
P25612,40911.30,112.703,6.7636,64860,0.735,104,175,104,45,187,176,96,50,46,363
Q00764,56147.82,113.430,5.9973,86290,0.597,123,241,144,70,261,234,121,62,59,495
P00127,17257.12,117.395,3.7225,11460,,23,60,32,16,54,93,77,19,58,147
P07263,59952.58,109.803,7.6878,47330,0.681,171,272,170,47,283,263,157,82,75,546
P38298,36419.69,115.252,8.2954,101300,0.711,80,137,109,57,201,115,60,36,24,316
P46995,84461.45,115.227,8.6410,57300,0.751,166,312,180,71,323,410,248,137,111,733
P53228,37253.61,111.873,6.3208,24870,,92,155,105,34,167,166,105,54,51,333
P07285,41374.44,108.880,6.6444,38390,0.714,118,195,121,45,208,172,92,51,41,380
P53311,16229.83,111.163,11.1560,31970,0.658,49,77,46,23,85,61,26,21,5,146
P54854,62931.48,110.990,8.1058,110240,0.819,177,280,180,87,367,200,95,53,42,567
P15179,75460.71,114.682,9.0440,60280,0.790,150,296,176,78,331,327,192,107,85,658
P21623,61390.71,114.535,6.5020,66810,0.609,136,253,136,78,264,272,159,84,75,536
P38225,77140.91,115.308,8.4591,122160,0.675,164,299,193,104,370,299,163,92,71,669
P42222,47312.61,108.267,5.0970,48360,0.556,142,234,144,41,244,193,110,53,57,437
P04173,38952.89,107.013,5.4774,27960,0.666,109,197,130,24,209,155,91,45,46,364
Q04533,74313.39,114.504,5.0163,73230,,161,288,176,84,332,317,191,91,100,649
P22434,42016.10,113.865,6.0543,41370,0.536,87,163,105,45,191,178,105,54,51,369
P00045,12532.31,110.905,10.1811,12950,0.714,37,57,21,13,54,59,34,23,11,113
P11412,57521.57,113.904,6.2143,58790,0.601,114,238,138,63,264,241,153,78,75,505
P05030,99619.37,108.518,4.7211,115280,,291,493,321,89,541,377,208,95,113,918
Q06204,48969.37,113.093,5.6272,41830,0.595,112,201,140,57,240,193,86,43,43,433
P25376,69671.38,110.065,6.9394,103250,0.694,207,313,213,90,393,240,118,64,54,633
Q03649,51437.60,114.560,8.4913,53750,0.827,111,216,111,62,235,214,125,71,54,449
Q03677,20879.38,116.645,4.9791,27390,,39,79,50,25,87,92,59,28,31,179
Q08234,145072.38,112.112,6.9633,133510,0.696,379,627,395,158,716,578,276,147,129,1294
P25297,64382.11,109.680,6.4076,79300,0.583,192,292,195,77,352,235,118,63,55,587
P14180,109881.62,114.103,8.8394,157570,0.804,262,463,268,138,509,454,229,131,98,963
P38827,123912.44,114.734,9.3539,92030,0.879,275,492,253,123,466,614,351,204,147,1080
P53871,40180.70,112.551,7.2464,34380,0.712,103,179,99,43,182,175,98,54,44,357
P0CH64,25152.48,111.789,5.9257,29910,0.504,66,123,71,27,121,104,51,26,25,225
P32622,55873.59,112.876,5.5463,46870,0.595,135,254,138,50,243,252,135,67,68,495
Q03175,40200.00,117.201,10.0252,45380,0.729,74,141,91,51,178,165,95,60,35,343
